薿	艹疑ノㄋ丶丶
熙	巳丶丶丶丶
蠹	橐石丨ㄋ丶丶
橐	橐石一丨丶丶
囊	橐吅一一丶丶
媲	女囟ノ丶ㄋㄋ
嬛	女罒丨ㄋ丶丶
澴	氵罒丨ㄋ丶丶
臀	尸共ノㄋ一一
硷	石佥ノ丶一一
擐	扌罒丨ㄋ丶丶
擒	扌人丶一丶丶
瑙	王巛ノ丨丶丶
圜	囗罒丨ㄋ丶丶
谘	讠次丨ㄋ一一
醾	酉麻丶ノ丶丶
巇	山虍一丨丶丶
沢	氵尺ㄋ一丶丶
有	⺝ノㄋ一一
壑	⺊冖一ノ一一
卫	ㄗ一一一一一
头	⺀大一ノ丶丶
斗	⺀十一丨丨丨
盥	𦥑水丨ㄋ一一
舆	𦥑车一ノ丶丶
爨	𦥑冂丨ㄋ丶丶
璺	𦥑冂丨ㄋ丶丶
删	冂冂一丨丨丨
彤	丹彡ノノノノ
飏	风汤ㄋノノノ
飗	风留丨ㄋ一一
飔	风田丶ㄋ丶丶
飐	风占丨一一一
粲	⺊夕ㄋ丶丶丶
睿	⺊冖一ノ一一
贞	⺊贝丨ㄋ丶丶
卣	⺊囗ㄋ一一一
桌	⺊日一丨丶丶
卢	⺊尸ㄋ一ノノ
攴	⺊又ㄋ丶丶丶
鸬	⺊尸ノㄋ一一
颅	⺊尸一ノ丶丶
鹾	⺊囗ノ丶一一
餐	⺊夕ㄋ丶丶丶
卓	卓丨一丨丨
泶	学水丨ㄋ丶丶
觉	学见丨ㄋㄋㄋ
鲎	学鱼ノㄋ一一
喾	学告ノ一一一
黉	学丨ㄋ丶丶
学	学子ㄋ丨一一
逮	隶辶丶ㄋ丶丶
书	丨丶丶丶
以	以ㄋ丶丶丶
带	带一丨丨丨
寿	寸一丨丶丶
帮	阝丨ㄋ丨丨
焘	寸丶丶丶丶
邦	阝ㄋ丨丨丨
眉	目丨ㄋ一一
鹛	目ノㄋ一一
郿	目ㄋ丨丨丨
才	才一丨ノノ
东	东一ㄋ丶丶
鸫	东鸟ノㄋ一一
高	高丶一一一
鹫	京尢丶ノ一一
膏	亮口丨ㄋ一一
烹	亨灬丶丶丶丶
亨	亨丶一丨丨
享	享丶一一一
亮	亮几ノㄋㄋㄋ
毫	亮毛ノ一ㄋㄋ
亳	亮乇ノ一ㄋㄋ
憝	享攵丶ㄋ丶丶
敲	高⺊ㄋ丶丶丶
就	京尢丶丶丶丶
鹑	享鸟ノㄋ一一
敦	享攵ノ一丶丶
孰	享九丶丶丶丶
郭	享阝ㄋ丨丨丨
熟	享九丶丶丶丶
塾	享九丶一一一
京	京丶一丶丶
亭	亮丁一丨丨丨
豪	亮豕一ノ丶丶
鄗	高阝ㄋ丨丨丨
#裛	亠口ノㄋ丶丶
勍	京力ㄋノノノ
彦	产彡ノノノノ
啻	帝巾丨ㄋ一一
帝	帝巾丨ㄋ丨丨
商	商丶一一一
旁	帝方丶一ノノ
颜	产彡一ノ丶丶
遆	帝巾丶ㄋ丶丶
鉴	监金ノ丶一一
监	监皿丨ㄋ一一
肾	坚⺝丨ㄋ一一
贤	坚贝丨ㄋ丶丶
竖	坚立丶一一一
坚	坚土一丨一一
临	丶丨一一
览	监见丨ㄋㄋㄋ
紧	坚糸ㄋㄋ丶丶
师	一丨ㄋ丨丨
归	彐ㄋ一一一
帅	巾丨ㄋ丨丨
翘	尧羽ㄋ丶一一
尧	尧一ㄋㄋㄋ
逯	录辶丶ㄋ丶丶
录	录ㄋ一丶丶
剥	录刂丨丨丨丨
袅	衣丶一丶丶
凫	几ノㄋㄋㄋ
枭	木一丨丶丶
岛	山丨ㄋ丨丨
乐	小丨ノ丶丶
卵	卵ノㄋ丶丶
迎	卩丶ㄋ丶丶
氏	氏ノㄋㄋㄋ
卿	卯ㄋ丨丨丨
卯	卯卩ㄋ丨丨丨
孵	卵爫ㄋ丨一一
鸱	氏丶ノㄋ一一
邸	氏丶ㄋ丨丨丨
印	卩ㄋ丨丨丨
氐	氏丶丶丶丶丶
昏	氏日丨ㄋ一一
遛	留田丶ㄋ丶丶
贸	留贝丨ㄋ丶丶
留	留田丨ㄋ一一
鹠	留田ノㄋ一一
鬼	鬼ノ丨丶丶
歙	合羽ノㄋ丶丶
舒	舍予ㄋ丶丨丨
剑	佥刂丨丨丨丨
敛	佥攵ノ一丶丶
鸽	合鸟ノㄋ一一
颌	合页一ノ丶丶
斜	余⺀一丨丨丨
叙	余又ㄋ丶丶丶
途	余辶丶ㄋ丶丶
翕	合羽ㄋ丶一一
龛	合龙一ノ丶丶
盒	合皿丨ㄋ一一
拿	合手ノ一丨丨
命	合卩ㄋ丨丨丨
龠	合吅丨ㄋ丨丨
舍	舍ノ丶一一
佥	佥ノ丶一一
合	合ノ丶一一
余	余ノ丶丶丶
龢	合吅丨ㄋ丶丶
郃	合阝ㄋ丨丨丨
弇	合廾一ノ丨丨
悆	余心丶ㄋ丶丶
畬	余田丨ㄋ一一
祭	祭ノㄋ丶丶
然	犬丶丶丶丶
炙	火丶ノ丶丶
久	久ノㄋ丶丶
灸	久火丶ノ丶丶
脊	人丨ㄋ一一
鹡	人丨ㄋ一一
坉	屯一ㄋㄋㄋ
坋	分ノ丶ノノ
坰	冂丨ㄋ一一
垎	各ノㄋ一一
垯	大丶ㄋ丶丶
垱	ㄋ一一一
埆	角ノㄋ丨丨
埇	甬ㄋ丶丨丨
埼	大一丨丨丨
堎	夋ㄋ丶丶丶
堨	曷丨ㄋㄋㄋ
塝	帝丶一ノノ
墈	其ㄋㄋノノ
墣	业丶ノ丶丶
墦	番ノ丶一一
追	辶丶ㄋ丶丶
阜	十一丨丨丨
背	北⺝丨ㄋ一一
冀	北田一丨丶丶
邶	北阝ㄋ丨丨丨
北	北丨一ㄋㄋ
顷	页一ノ丶丶
光	光丨丶ㄋㄋ
耀	光羽ノ丨一一
辉	光冖一ㄋ丨丨
赏	贝丨ㄋ丶丶
裳	衣丶一丶丶
党	儿ノㄋㄋㄋ
常	巾丨ㄋ丨丨
棠	木一丨丶丶
掌	手ノ一丨丨
堂	土一丨一一
䣘	土ㄋ丨丨丨
隶	隶ㄋ一丶丶
丝	一一一一
鸶	一ノ一一
乡	乡ㄋㄋノノ
发	发ㄋノ丶丶
民	民ㄋ一ㄋㄋ
愍	民攵丶ㄋ丶丶
遘	冓辶丶ㄋ丶丶
觏	冓见丨ㄋㄋㄋ
失	丿夫一一丶丶
迭	丿夫丶ㄋ丶丶
卸	止ㄋ丨丨丨
那	阝ㄋ丨丨丨
遁	十丨ㄋ丶丶
逅	同丶ㄋ丶丶
返	又丶ㄋ丶丶
质	十丨ㄋ丶丶
盾	十丨ㄋ一一
后	同丨ㄋ一一
卮	一ㄋㄋㄋㄋ
反	又ㄋ丶丶丶
段	段ノ丨丶丶
殷	彐ㄋノ丶丶
所	ノノ丨丨
虒	虍ノㄋㄋㄋ
郈	同ㄋ丨丨丨
垕	同一丨一一
存	在子ㄋ丨一一
左	工一丨一一
灰	火丶ノ丶丶
布	巾丨ㄋ丨丨
右	口丨ㄋ一一
友	又ㄋ丶丶丶
盔	火丨ㄋ一一
龙	龙一ノ丶丶
丈	丶丶丶丶丶
雄	厶ノ丨一一
郁	⺝ㄋ丨丨丨
在	在土一丨一一
翃	厶ㄋ丶一一
迕	十丶ㄋ丶丶
迤	也丶ㄋ丶丶
迄	乙丶ㄋ丶丶
舞	卌ノㄋ丨丨
每	每ノ一丶丶
复	复ノ一丶丶
午	十一丨丨丨
乞	乙ㄋㄋㄋㄋ
年	一丨丨丨
榘	大一ㄋ丶丶
毓	每㐬丶一ㄋㄋ
敏	每攵ノ一丶丶
鳘	每攵ノㄋ一一
繁	每攵ㄋㄋ丶丶
司	同一丨一一
刁	一一一一一
虱	丿丨ㄋ丶丶
迅	十丶ㄋ丶丶
飞	ノ丶丶丶
迩	尔辶丶ㄋ丶丶
詹	厃八丶一一一
危	厃㔾ㄋㄋㄋㄋ
玺	尔王丶丶丶丶
急	刍心丶ㄋ丶丶
负	贝丨ㄋ丶丶
色	巴ㄋ丨ㄋㄋ
刍	刍ノㄋ一一
象	象ノㄋ丶丶
奂	央丨ㄋ丶丶
龟	日ㄋㄋㄋㄋ
皱	刍皮ㄋノ丶丶
雏	刍隹ノ丨一一
邹	刍阝ㄋ丨丨丨
争	争ノㄋ丨丨
尔	尔ノㄋ丶丶
煞	刍攵丶丶丶丶
鹐	臼ノㄋ一一
通	甬辶丶ㄋ丶丶
勇	甬力ㄋノノノ
恿	甬心丶ㄋ丶丶
甬	甬ㄋ丶丨丨
氅	尚攵ノ一ㄋㄋ
尚	尚丨丶一一
当	彐ㄋ一一一
敞	尚攵ノ一丶丶
掰	分ノ一丨丨
拜	一一一丨丨
看	目丨ㄋ一一
搿	合ノ一丨丨
责	贝丨ㄋ丶丶
表	ノㄋ丶丶
毒	母ㄋㄋ丶丶
麦	夂ノㄋ丶丶
敖	敖一一丶丶
麸	夂一一丶丶
遨	敖辶丶ㄋ丶丶
赘	敖贝丨ㄋ丶丶
鳌	敖鱼ノㄋ一一
螯	敖虫丨ㄋ丶丶
聱	敖耳一丨一一
熬	敖灬丶丶丶丶
鏊	敖金ノ丶一一
骜	敖马ㄋㄋ一一
獒	敖犬一ノ丶丶
纛	母丨ㄋ丶丶
素	糸ㄋㄋ丶丶
麹	夂ノㄋ丶丶
恭	共丨丶丶丶
巷	共巳ㄋ一ㄋㄋ
共	共一丨丶丶
昔	昔一丨一一
散	⺝ノ一丶丶
鹊	昔鸟ノㄋ一一
黄	由ノ丶丶丶
黇	由ノ丶一一
䢼	共阝ㄋ丨丨丨
选	先辶丶ㄋ丶丶
赞	先先丨ㄋ丶丶
先	先ノ一ㄋㄋ
鹄	告鸟ノㄋ一一
郜	告阝ㄋ丨丨丨
造	告辶丶ㄋ丶丶
靠	告非丨一一一
告	告ノ一一一
酂	先先丨ㄋ丨丨
蠢	日丨ㄋ丶丶
奏	夭一一丶丶
奉	一一丨丨
秦	禾ノ一丶丶
舂	臼ノ丨一一
春	日丨ㄋ一一
泰	氺丨丶丶丶
尝	冖一一丶丶
筚	比一丨丨丨
篡	目一ノ丶丶
箧	匚一丶丶丶
笸	匚丨ㄋ一一
筐	匚一一一一
筱	亻丨ノ丶丶
簖	米ㄋノ丨丨
簸	其ㄋノ丶丶
筛	一丨丨丨
筠	土ノㄋ一一
篌	亻ノ丨丶丶
符	付ノ丨丶丶
筏	亻一ㄋ丶丶
簇	族ノ一丶丶
筑	工ノㄋ丶丶
筇	工ㄋ丨丨丨
籍	耒一丨一一
笳	加ㄋノ一一
箱	相一丨一一
簿	氵一丨丶丶
箔	氵ノ丨一一
筷	忄ㄋ一丶丶
簌	束ノㄋ丶丶
籁	束ノㄋ丶丶
箍	扌一ㄋ丨丨
箨	扌ㄋ丶丨丨
筢	扌ㄋ丨ㄋㄋ
筘	扌丨ㄋ一一
筋	月ㄋノノノ
笥	丨ㄋ一一
笏	勿ノㄋノノ
笱	句ノㄋ一一
第	弓丨ノノノ
筵	丿丨一丶丶
篷	夂一一丶丶
笾	力丶ㄋ丶丶
篙	高丶一一一
简	门丨ㄋ一一
筒	冂丨ㄋ一一
箴	咸一ノ丶丶
篦	囟ノ丶ㄋㄋ
篪	丨一ㄋㄋ
筹	一丨丶丶
簏	鹿丶一ㄋㄋ
篇	户丨ㄋ丨丨
篑	贵丨ㄋ丶丶
箸	者一丨一一
箕	其ノ丶丶丶
篮	监丨ㄋ一一
簪	旡一ㄋ一一
箜	穴一丨一一
箢	宀ノㄋㄋㄋ
管	宀丨ㄋ一一
筲	肖丨丶一一
箐	青一一一一
筅	先ノ一ㄋㄋ
箪	单丶ノ丨丨
篁	白一一一一
箬	艹一ノ一一
笤	召ㄋノ一一
篆	彖ㄋㄋ丶丶
篝	冓一一一一
笪	旦丨ㄋ一一
笞	台ㄋ丶一一
箅	畀丨ㄋ丨丨
等	土一丨丶丶
筌	人一一一一
篥	覀一丨丶丶
笄	开一一丨丨
箦	丨ㄋ丶丶
箭	前丶ノ丨丨
笫	弟ノㄋノノ
笆	巴ㄋ丨ㄋㄋ
笨	木一一一一
策	朿一丨丶丶
篼	白ノㄋㄋㄋ
竺	二一一一一
竿	干一一丨丨
筻	更一丨丶丶
笈	及ノㄋ丶丶
笺	戋一一丶丶
笠	立丶一一一
笼	龙一ノ丶丶
笃	马ㄋㄋ一一
笔	毛ノ一ㄋㄋ
篓	米ㄋノ一一
算	目一ノ丨丨
笙	生ノ一一一
篾	罒一ノ丶丶
箩	罒ノㄋ丶丶
箫	肀ノ丨丶丶
筮	工ノ丶丶丶
笋	尹ㄋ一ノノ
笮	乍ノ一一一
笊	爪ノノ丶丶
簦	登ㄋ丶一一
箝	扌一丨一一
筝	争ノㄋ丨丨
纂	目一ノ丶丶
篚	匚丨一一一
籀	扌ノㄋ一一
笕	见丨ㄋㄋㄋ
篱	㐫丨ㄋ丶丶
签	佥ノ丶一一
答	合ノ丶一一
簧	丨ㄋ丶丶
笑	夭ノ一丶丶
簟	覀丨ㄋ丨丨
簋	艮丨ㄋ一一
笛	由丨ㄋ一一
竽	于一一丨丨
箓	录ㄋ一丶丶
篯	钅一一丶丶
籥	合丨ㄋ丨丨
箖	林一丨丶丶
筦	宀一一ㄋㄋ
簰	片ノ丨丨丨
筼	口丨ㄋ丶丶
簃	禾ノㄋ丶丶
簕	革ㄋノノノ
筶	告ノ一一一
筥	口丨ㄋ一一
簠	甫丨ㄋ一一
簝	尞一ノ丶丶
筜	ㄋ一一一
筀	圭一丨一一
羞	丑ㄋ丨一一
差	工一丨一一
着	目丨ㄋ一一
羌	乚ㄋㄋㄋㄋ
翔	羽ㄋ丶一一
羟	轻ㄋ丶一一
羰	山一ノノノ
羝	氏丶丶丶丶
羧	夋ㄋ丶丶丶
羯	曷丨ㄋㄋㄋ
鲝	鱼ノㄋ一一
羖	殳ノㄋ丶丶
羲	禾一ㄋ丶丶
羹	灬丶ノ丶丶
羡	次丶一丶丶
美	大一ノ丶丶
盖	皿丨ㄋ一一
姜	女ㄋノ一一
恙	心丶ㄋ丶丶
羔	灬丶丶丶丶
羑	久ノㄋ丶丶
羕	永丶ㄋ丶丶
鲞	鱼ノㄋ一一
券	刀ㄋノノノ
桊	木一丨丶丶
眷	目丨ㄋ一一
豢	豕一ノ丶丶
拳	手ノ一丨丨
卷	㔾ㄋㄋㄋㄋ
誊	言丶一一一
鹭	各ノㄋ一一
距	匚ㄋ一一一
蹴	京一ノ丶丶
跗	付ノ丨丶丶
跏	加ㄋノ一一
跌	丿一一丶丶
踟	矢丨ㄋ一一
趵	勹丶丶丶丶
跑	勹ㄋ一ㄋㄋ
踺	聿ㄋ丶丶丶
跹	千丶ㄋ丶丶
跪	厃ㄋㄋㄋㄋ
踬	一丨丶丶
踌	一丨丶丶
蹉	一丨一一
蹰	厂一丨丶丶
蹶	厂丶ノ丶丶
躔	广丨ㄋ一一
踮	广丨一一一
踱	度ㄋ丶丶丶
蹁	户丨ㄋ丨丨
踞	尸一丨一一
跷	尧一ㄋㄋㄋ
躜	先ノ一丶丶
跸	比一丨丨丨
躞	火丶一丶丶
蹄	帝丨ㄋ丨丨
蹿	穴丨ㄋ丨丨
蹲	酋一丨丶丶
跎	宀ノㄋㄋㄋ
踪	宀一一丶丶
跤	交丶一丶丶
躁	口丨ㄋ丶丶
蹯	番ノ丶一一
跣	先ノ一ㄋㄋ
踯	䒑一ノ丨丨
蹭	曾丶ノ一一
跄	仓ㄋㄋㄋㄋ
蹬	登ㄋ丶一一
踔	卓丨一丨丨
躏	艹丶丨一一
躇	艹一丨一一
躐	巛丨ㄋㄋㄋ
跨	大一一ㄋㄋ
踉	良丶ㄋ丶丶
蹑	耳ㄋ丶丶丶
跺	几一丨丶丶
跽	己丶ㄋ丶丶
踣	立丨ㄋ一一
蹂	矛一丨丶丶
跃	夭ノ一丶丶
踢	日ノㄋノノ
蹦	山ノㄋ一一
踹	山一ノ丨丨
蹀	世一丨丶丶
踏	水丨ㄋ一一
跆	台ㄋ丶一一
躅	罒ノㄋ丶丶
跬	圭一丨一一
跻	文ノ丨丨丨
蹼	业丶ノ丶丶
趼	开一一丨丨
蹋	日ㄋ丶一一
蹈	爫ノ丨一一
踩	爫一丨丶丶
蹊	爫ㄋㄋ丶丶
路	各ノㄋ一一
踊	甬ㄋ丶丨丨
蹒	艹一丨丶丶
趴	八ノ丶丶丶
跋	ㄋ丶丶丶
跚	冂丨ㄋ一一
趺	夫一一丶丶
跟	艮ㄋ一丶丶
踝	日一丨丶丶
趿	及ノㄋ丶丶
践	戋一一丶丶
跞	丨ノ丶丶
跛	皮ㄋノ丶丶
跖	石一ノ一一
踽	禹ノ丨丶丶
跳	儿丶一丶丶
趾	止丨一一一
踵	千丨ㄋ一一
蹚	一丨一一
跶	大丶ㄋ丶丶
蹐	ノ丶一一
跐	此丨一ㄋㄋ
蹅	木丨ㄋ一一
踦	大一丨丨丨
蹾	享ノ一丶丶
跂	十ㄋ丶丶丶
蹽	尞一ノ丶丶
跱	土一丨丶丶
踶	是丨ㄋ丶丶
蹜	宀ノ丨一一
踒	禾ㄋノ一一
谷	谷ノ丶一一
翁	公羽ㄋ丶一一
瓮	公瓦一ㄋ丶丶
公	公ノ丶丶丶
八	八ノ丶丶丶
父	父ノ丶丶丶
鹆	谷鸟ノㄋ一一
欲	谷欠ノㄋ丶丶
颂	公页一ノ丶丶
兮	八丂一ㄋㄋㄋ
釜	父干丶ノ一一
爹	父夕ノㄋ丶丶
爸	父巴ㄋ丨ㄋㄋ
爷	父卩ㄋ丨丨丨
斧	父斤ノノ丨丨
郤	谷阝ㄋ丨丨丨
鹟	公羽ノㄋ一一
谼	谷共一丨丶丶
遂	㒸辶丶ㄋ丶丶
递	弟辶丶ㄋ丶丶
单	单丶ノ丨丨
兑	总儿ノㄋㄋㄋ
曾	曾丶ノ一一
总	总心丶ㄋ丶丶
兽	丷田一丨一一
半	半丶ノ丨丨
弟	弟丶ノノノ
丫	丷丨丨丨丨丨
冁	单尸一丨丶丶
郸	单阝ㄋ丨丨丨
甑	曾瓦一ㄋ丶丶
猷	酋犬一ノ丶丶
叛	半ㄋ丶丶丶
判	半刂丨丨丨丨
鹈	弟鸟ノㄋ一一
剃	弟刂丨丨丨丨
遵	酋寸丶ㄋ丶丶
遒	酋辶丶ㄋ丶丶
尊	酋寸一丨丶丶
奠	酋大一ノ丶丶
酋	酋丶ノ一一
鄫	曾阝ㄋ丨丨丨
䎖	曾羽ㄋ丶一一
巴	巴ㄋ丨ㄋㄋ
遑	白王丶ㄋ丶丶
迫	白辶丶ㄋ丶丶
卑	卑ノ丨丨丨
皋	白大一丨丨丨
帛	白巾丨ㄋ丨丨
皂	白七一ㄋㄋㄋ
泉	白水丨ㄋ丶丶
皇	白王一一一一
白	白ノ丨一一
兜	白𦥑ノㄋㄋㄋ
鹎	卑鸟ノㄋ一一
郫	卑阝ㄋ丨丨丨
翱	白大一丨一一
敫	白方ノ一丶丶
的	白勹丶丶丶丶
皈	白ㄋ丶丶丶
皖	白宀一一ㄋㄋ
皎	白交丶一丶丶
皤	白番ノ丶一一
皓	白告ノ一一一
皑	白山ㄋ一ㄋㄋ
魄	白鬼ノ丨丶丶
邀	白方ノ一丶丶
邬	乌阝一ㄋ丨丨
匐	勹同丨ㄋ一一
勿	勿ノㄋノノ
勺	勹丶丶丶丶丶
匍	勹甫一丨丶丶
句	句ノㄋ一一
匀	勹冫丶一一一
旬	勹日丨ㄋ一一
勾	勹厶ㄋ丶丶丶
包	勹巳ㄋ一ㄋㄋ
甸	勹田丨ㄋ一一
訇	勹言丶一一一
忽	勿心丶ㄋ丶丶
乌	乌一一一一
匆	勿丶丶丶丶丶
刎	勿刂丨丨丨丨
鸲	句鸟ノㄋ一一
够	句夕ノㄋ丶丶
劬	句力ㄋノノノ
郇	勹隹ㄋ丨丨丨
刨	勹巳丨丨丨丨
匈	勹乂ㄋ丨丨丨
雊	句隹ノ丨一一
逭	宀㠯丶ㄋ丶丶
赛	寒贝丨ㄋ丶丶
褰	寒衣丶一丶丶
蹇	寒足丨ㄋ丶丶
寒	寒⺀丶丶丶丶
骞	寒马ㄋㄋ一一
寨	寒朩一丨丶丶
搴	寒手ノ一丨丨
塞	寒土一丨一一
謇	寒言丶一一一
蜜	宀必丨ㄋ丶丶
密	宀必丨ㄋ丨丨
案	宀女一丨丶丶
寡	宀丆丨ㄋノノ
寂	宀上丨ノ丶丶
宿	宀亻一ノ一一
寐	宀爿一一丶丶
宛	宀夗ノㄋㄋㄋ
寝	宀丬ㄋ一丶丶
寇	宀元丨一丶丶
宏	宀ㄋ丶丶丶
宸	宀辰一ノ丶丶
室	宀至一ㄋ一一
察	宀祭ノㄋ丶丶
寥	宀羽ノ丶ノノ
寮	宀尞一ノ丶丶
宵	宀肖丨丶一一
宪	宀先ノ一ㄋㄋ
寞	宀莫一丨丶丶
宫	宀口丨ㄋ一一
宾	宀丘ノ丶丶丶
寰	宀罒丨ㄋ丶丶
宣	㝉旦丨ㄋ一一
富	宀同丨ㄋ一一
完	宀元一一ㄋㄋ
宴	宀日ㄋノ一一
宥	宀丨ㄋ一一
客	宀各ノㄋ一一
定	定丶丶丶丶
它	宀匕ノㄋㄋㄋ
宓	宀必丶ㄋ丶丶
宦	宀臣一丨ㄋㄋ
守	宀寸一丨丶丶
害	宀丰丨ㄋ一一
灾	宀火丶ノ丶丶
宄	宀九ノㄋㄋㄋ
宠	宀龙一ノ丶丶
宋	宀木一丨丶丶
牢	宀牛ノ一丨丨
安	宀女ㄋノ一一
宜	宀且丨ㄋ一一
审	宀日丨丨丨丨
宕	宀石一ノ一一
家	宀豕一ノ丶丶
宗	宀示一一丶丶
实	宀⺀一ノ丶丶
宅	宀乇ノ一ㄋㄋ
宝	宀王丶丶丶丶
官	宀㠯丨ㄋ一一
字	宀子ㄋ丨一一
剜	宀夗丨丨丨丨
额	宀各一ノ丶丶
豁	宀丰丨ㄋ一一
割	宀丰丨ㄋ丨丨
寤	宀爿一丨一一
寄	宀大一丨丨丨
宰	宀辛丶一丨丨
寅	㝉由ノ丶丶丶
宽	宀艹丨ㄋㄋㄋ
宁	宀丁一丨丨丨
甯	宀心丨ㄋ一一
宙	宀由丨ㄋ一一
宇	宀于一一丨丨
寓	宀禺丨ㄋ丶丶
宧	宀一丨一一
贝	贝丨ㄋ丶丶
罂	贝贝ノ一丨丨
婴	贝贝ㄋノ一一
赋	贝一一ㄋ一一
购	贝勹ㄋ丶丶丶
贼	贝戈一ノノノ
赆	贝尺丶丶丶丶
赡	贝厃ノ丶一一
赈	贝辰一ノ丶丶
赃	贝广一丨一一
贩	贝ㄋ丶丶丶
赌	贝者一丨一一
贮	贝㝉丶丶一一
赅	贝亥丶一丶丶
赠	贝曾丶ノ一一
贴	贝占丨一一一
赙	贝甫一丨丶丶
赕	贝炎丶ノ丶丶
贶	贝口ノㄋㄋㄋ
赔	贝立丨ㄋ一一
贬	贝丿丶ㄋ丶丶
赐	贝日ノㄋノノ
赎	贝十ㄋ丶丶丶
赊	贝人一一丶丶
贻	贝台ㄋ丶一一
贿	贝丨ㄋ一一
赂	贝各ノㄋ一一
赚	贝兼丶ノ丶丶
财	贝才一丨ノノ
则	贝刂丨丨丨丨
败	贝攵ノ一丶丶
贱	贝戋一一丶丶
赇	贝求一丨丶丶
账	贝长ノ一丶丶
鹦	贝贝ㄋノ一一
赒	贝冂一丨一一
赗	贝日丨ㄋ一一
赑	贝贝丨ㄋ丶丶
旨	旨ノㄋ一一
匕	匕ノㄋㄋㄋ
颖	匕禾一ノ丶丶
鸨	匕十ノㄋ一一
疑	疑ノㄋ丶丶
肄	匕矢ㄋ一丨丨
颍	匕水一ノ丶丶
颎	匕火一ノ丶丶
毙	比歹ノㄋㄋㄋ
皆	比白ノ丨一一
毖	比必丶ㄋ丶丶
毕	比十一丨丨丨
比	比一ㄋㄋㄋ
鳖	敝鱼ノㄋ一一
蹩	敝足丨ㄋ丶丶
弊	敝廾一ノ丨丨
瞥	敝目丨ㄋ一一
憋	敝心丶ㄋ丶丶
敝	敝丶ノ丶丶
瘸	疒加丨ㄋ丶丶
疖	疒卩ㄋ丨丨丨
癣	疒鱼丶ノ丨丨
癜	疒尸一丨丶丶
癫	疒直ノ丶丶丶
瘊	疒亻ノ丨丶丶
瘀	疒方ノ丶丶丶
痢	疒禾丨丨丨丨
痂	疒加ㄋノ一一
痧	疒氵丨ノノノ
痴	疒矢丨ㄋ一一
癞	疒束ノㄋ丶丶
瘌	疒束丨丨丨丨
癍	疒王丶一一一
瘫	疒又ノ丨一一
疵	疒此丨一ㄋㄋ
瘢	疒舟ノㄋ丶丶
瘾	疒阝ノㄋ丶丶
癃	疒阝ノㄋ一一
疡	疒汤ㄋノノノ
疱	疒勹ㄋ一ㄋㄋ
痫	疒门一丨丶丶
疯	疒风ノㄋ丶丶
瘥	疒一丨一一
疬	疒厂ㄋノノノ
瘠	疒ノ丶一一
瘿	疒贝丨ㄋ一一
瘵	疒祭ノㄋ丶丶
瘛	疒丰ㄋノ丶丶
癯	疒目丨ㄋ一一
瘳	疒羽ノ丶ノノ
瘙	疒又丶丨丶丶
痃	疒玄丶一丶丶
癔	疒音丶ㄋ丶丶
痉	疒轻ㄋ丶一一
疥	疒人ノ丨丨丨
疙	疒ㄋㄋㄋㄋ
痪	疒丨ㄋ丶丶
瘅	疒单丶ノ丨丨
瘼	疒莫一丨丶丶
痨	疒劳ㄋノノノ
疰	疒主丶一一一
痿	疒禾ㄋノ一一
痰	疒炎丶ノ丶丶
疫	疒殳ノㄋ丶丶
瘗	疒夹ノ丶一一
瘘	疒米ㄋノ一一
疸	疒旦丨ㄋ一一
疹	疒㐱ノ丶ノノ
瘁	疒卒丶一丨丨
痣	疒士丶ㄋ丶丶
痹	疒畀丨ㄋ丨丨
痔	疒土一丨丶丶
痊	疒人一一一一
瘭	疒覀一一丶丶
疮	疒仓ノ丶ㄋㄋ
症	疒正一丨一一
瘦	疒臼丨ㄋ丶丶
瘟	疒日丨ㄋ一一
疼	疒夂丶丶丶丶
瘪	疒自ノ丶ㄋㄋ
痛	疒甬ㄋ丶丨丨
疟	疒一ㄋ一一
疤	疒巴ㄋ丨ㄋㄋ
瘃	疒豕丶丶丶丶
痘	疒豆一丨一一
瘕	疒叚ㄋ一丶丶
疚	疒久ノㄋ丶丶
疗	疒了ㄋ丨丨丨
疲	疒皮ㄋノ丶丶
疽	疒且丨ㄋ一一
疝	疒山丨ㄋ丨丨
疾	疒矢ノ一丶丶
疠	疒万一ㄋノノ
痒	疒羊丶ノ丨丨
痍	疒大ㄋ一ㄋㄋ
痈	疒用ノㄋ丨丨
疣	疒尢丶丶丶丶
瘐	疒臼ノ丶丶丶
痄	疒乍ノ一一一
痤	疒从一丨一一
痖	疒亚一丨一一
癖	疒辟ㄋ一丨丨
疴	疒可一丨丨丨
痼	疒囗一丨一一
瘤	疒留丨ㄋ一一
癌	疒口丨ㄋ丨丨
痞	疒不丨ㄋ一一
瘩	疒艹ノ丶一一
瘴	疒音一丨丨丨
癀	疒丨ㄋ丶丶
瘰	疒田ㄋㄋ丶丶
痦	疒五丨ㄋ一一
病	疒丙ノ丶丶丶
疔	疒丁一丨丨丨
痱	疒非丨一一一
痕	疒艮ㄋ一丶丶
痓	疒至一ㄋ一一
瘆	疒叁ノノノノ
凳	登几ノㄋㄋㄋ
癸	癸ㄋ丶丶丶
登	登ㄋ丶一一
戣	癸戈一ㄋ丶丶
卜	卜丨丶丶丶
邳	不一ㄋ丨丨丨
还	不辶丶ㄋ丶丶
孬	不女ㄋ丨一一
歪	不正一丨一一
否	不口丨ㄋ一一
丕	不一一一一一
甭	不用ノㄋ丨丨
檠	芍口ノ一丶丶
擎	芍口ノ一丨丨
警	芍口ノ一一一
荜	艹比一丨丨丨
藁	艹高一丨丶丶
惹	艹丨ㄋ丶丶
薨	萝冖一ノㄋㄋ
瞢	萝目丨ㄋ一一
甍	萝冖一ㄋ丶丶
节	艹ㄗㄋ丨丨丨
菟	艹免丶丶丶丶
苣	艹匚ㄋ一一一
茆	艹卯ㄋ丨丨丨
莜	荷丨ノ一丶丶
蔚	艹尸一一丶丶
蓟	艹鱼丨丨丨丨
藓	艹鱼丶ノ丨丨
蕲	艹单ノノ丨丨
蕺	艹口一丨丶丶
薪	艹立一丨丨丨
薮	艹米ㄋノ丶丶
菽	艹上丨ノ丶丶
菸	艹方ノ丶丶丶
茇	艹ㄋ丶丶丶
孽	艹丶一一一
蒯	艹月ノㄋ丨丨
敬	芍口ノ一丶丶
荆	艹开丨丨丨丨
劐	艹隹ㄋ丶丨丨
颟	艹丙ノ丶丶丶
鹋	艹田ノㄋ一一
鹳	艹吅ノ丨一一
颧	艹吅ノ丨丶丶
葜	艹丰ㄋノ丶丶
蘖	艹丶一丶丶
蔹	艹佥ノ一丶丶
薛	艹丶一丨丨
薜	艹辟ㄋ一丨丨
葫	艹古ノㄋ一一
葑	艹圭一丨丶丶
莰	艹土ノㄋ丶丶
芘	艹比一ㄋㄋㄋ
茚	艹ㄋ丨丨丨
蔬	艹丶一ㄋㄋ
葩	艹白ㄋ丨ㄋㄋ
蔽	艹敝丶ノ丶丶
蕻	艹镸一丨丶丶
薇	艹微ノㄋ丶丶
蘅	艹彳ノㄋ丨丨
荇	艹彳一一丨丨
蓰	艹彳丨一丶丶
薤	艹歹丨一一一
荷	荷可一丨丨丨
葆	荷口一丨丶丶
蓓	荷立丨ㄋ一一
荏	荷壬ノ一一一
花	荷七ノㄋㄋㄋ
苻	荷寸一丨丶丶
莅	荷立丶一一一
茯	荷犬一ノ丶丶
茌	荷士一丨一一
荻	艹犭丶ノ丶丶
获	艹犭一ノ丶丶
莸	艹犭一ノㄋㄋ
蔟	艹族ノ一丶丶
莉	艹禾丨丨丨丨
药	艹纟ノㄋ丶丶
蕴	艹纟丨ㄋ一一
荮	艹纟一丨丶丶
荭	艹纟一丨一一
莼	艹纟一ㄋㄋㄋ
萜	艹巾丨一一一
藉	艹耒一丨一一
藕	艹耒丨ㄋ丶丶
茄	艹加ㄋノ一一
茨	艹次丶一丶丶
菘	艹木ノ丶丶丶
菥	艹木ノノ丨丨
葙	艹相一丨一一
蒴	艹屰ノㄋ一一
薅	艹女一ノノノ
菇	艹女一丨一一
茹	艹女丨ㄋ一一
茱	艹丿一一丶丶
苁	艹从ノ丶丶丶
莳	艹日一丨丶丶
萌	艹日ノㄋ一一
荡	落汤ㄋノノノ
菏	落可一丨丨丨
茫	落亡丶一ㄋㄋ
藻	落口丨ㄋ丶丶
藩	落番ノ丶一一
蒗	落良丶ㄋ丶丶
薄	落甫一丨丶丶
莎	落小ノノノノ
落	落各ノㄋ一一
蒎	落ノㄋ丶丶
蒲	落甫一丨丶丶
茳	落工一丨一一
菠	落皮ㄋノ丶丶
萍	落平一丶丨丨
菹	落且丨ㄋ一一
范	落㔾ㄋㄋㄋㄋ
蒜	艹示一一丶丶
蔌	艹束ノㄋ丶丶
菝	艹扌一ノノノ
苑	艹夗ノㄋㄋㄋ
蔼	艹讠丨ㄋㄋㄋ
蘸	艹酉ノ丨丶丶
蓣	艹予一ノ丶丶
藤	艹月丶ノ丶丶
菔	艹月ㄋ丨丨丨
茈	艹此丨一ㄋㄋ
藐	艹豸ノ丨一一
蒋	艹丬ノㄋ丶丶
菰	艹孑ノノ丶丶
荪	艹孑丨ノ丶丶
芤	艹孑ㄋㄋㄋㄋ
萨	艹阝丶一ノノ
荫	艹阝ノㄋ一一
苛	艹可一丨丨丨
茑	艹鸟ノㄋ一一
芴	艹勿ノㄋノノ
芍	芍丶丶丶丶丶
萄	芍缶ノ一丨丨
葡	芍甫一丨丶丶
苟	芍口丨ㄋ一一
菊	芍米丶ノ丶丶
荀	芍日丨ㄋ一一
苞	芍巳ㄋ一ㄋㄋ
蕤	艹豕ノ一一一
莛	艹壬ㄋ丶丶丶
蘧	艹虍一ノ丶丶
蓬	艹夂一一丨丨
莲	艹车丶ㄋ丶丶
藏	艹戊ㄋ一ㄋㄋ
葳	艹戊一ㄋ一一
蒿	艹高丶一一一
苋	艹见丨ㄋㄋㄋ
蔺	艹门ノ丨一一
茼	艹冂丨ㄋ一一
苘	艹冂丨ㄋ一一
蒇	艹戊丨ㄋ丶丶
蓖	艹囟ノ丶ㄋㄋ
茵	艹因丨ㄋ一一
菌	艹囗ノ一丶丶
茴	艹回丨ㄋ一一
茬	艹在一丨一一
荐	艹在ㄋ丨一一
蘼	艹麻丨一一一
蘑	艹麻一ノ一一
蒺	艹疒ノ一丶丶
蕨	艹厂丶ノ丶丶
苈	艹厂ㄋノノノ
苊	艹厂ㄋㄋㄋㄋ
葬	艹歹ノㄋ丨丨
蔗	艹度丶丶丶丶
若	艹丨ㄋ一一
菡	艹了丶一丨丨
萆	艹卑ノ丨丨丨
芡	艹欠ノㄋ丶丶
蒉	艹贵丨ㄋ丶丶
蕙	艹惠丶ㄋ丶丶
著	艹者一丨一一
蓍	艹耂ノㄋ一一
萋	艹妻ㄋノ一一
萁	艹其一丨丶丶
蔷	艹十丶ノ一一
荛	艹尧一ㄋㄋㄋ
蘩	艹每ノ一丶丶
蔡	艹祭ノㄋ丶丶
蓝	艹监丨ㄋ一一
蒈	艹比ノ丨一一
藜	艹禾ノㄋ丶丶
蕖	落匚一ㄋㄋㄋ
蓼	艹羽ノ丶ノノ
蒽	艹因丶ㄋ丶丶
蓐	艹辰一丨丶丶
葚	艹其ㄋㄋㄋㄋ
蒂	艹帝丨ㄋ丨丨
蓠	艹㐫丨ㄋ丶丶
荒	艹亡ノ丨ㄋㄋ
蒡	艹帝丶一ノノ
葶	艹亮一丨丨丨
蓄	艹玄丶一丶丶
蓊	艹公ㄋ丶一一
芩	艹今ノ丶ㄋㄋ
苓	艹令ノ丶丶丶
蓿	艹宀ノ丨一一
菀	艹宀ノㄋㄋㄋ
蔻	艹宀一一丶丶
蓉	艹宀ノ丶一一
萱	艹㝉丨ㄋ一一
莞	艹宀一一ㄋㄋ
菪	艹宀一ノ一一
苎	艹㝉丶丶一一
菅	艹宀丨ㄋ一一
蕹	艹亠ㄋㄋ一一
茺	艹ノㄋㄋㄋ
芒	艹亡丶一ㄋㄋ
#蓑	艹哀一ノ丶丶
茭	艹交丶一丶丶
荟	艹人一一丶丶
薏	艹音丶ㄋ丶丶
荞	艹夭ノ丨丨丨
蕃	艹番ノ丶一一
荸	艹孛ㄋ丨一一
薹	艹吉丶ㄋ一一
莶	艹佥ノ丶一一
荼	艹余ノ丶丶丶
蔫	艹正一ㄋ丶丶
蒸	艹丞丶丶丶丶
茎	艹轻ㄋ丶一一
芥	艹人ノ丨丨丨
莓	艹每ノ一丶丶
萏	艹ノ丨一一
菁	艹青一一一一
蓁	艹ノ一丶丶
芬	艹分ノ丶ノノ
葵	艹癸ㄋ丶丶丶
苫	艹占丨一一一
苤	艹不一一一一
荩	艹尺丶丶丶丶
葱	艹勿丶丶丶丶
萘	艹大一一丶丶
苕	艹召ㄋノ一一
莨	艹良丶ㄋ丶丶
苄	艹丶一丨丶丶
芸	艹云一一丶丶
莠	艹禾ㄋノノノ
萎	艹禾ㄋノ一一
芟	艹殳ノㄋ丶丶
荨	艹彐一丨丶丶
葺	艹口一丨一一
莒	艹口丨ㄋ一一
莴	艹呙丨ㄋ丶丶
荔	艹力ㄋノノノ
菩	艹立丨ㄋ一一
莘	艹辛丶一丨丨
蒌	艹米ㄋノ一一
蒙	劳一一ノ丶丶
蕞	艹日一丨一一
草	艹早丨ㄋ丨丨
菖	艹日丨ㄋ一一
萃	艹卒丶一丨丨
苦	艹古一丨一一
芰	艹十ㄋ丶丶丶
苔	艹台ㄋ丶一一
薯	萝者一丨一一
葸	艹田丶ㄋ丶丶
菱	艹土ノ丶丶丶
荃	艹人一一一一
荠	艹文ノ丨丨丨
茗	艹夕丨ㄋ一一
蕈	艹覀丨ㄋ丨丨
苍	艹仓ノ丶ㄋㄋ
蕊	艹心丶ㄋ丶丶
萼	艹吅一一ㄋㄋ
芫	艹元ノㄋㄋㄋ
荬	艹买ㄋ丶丶丶
薷	艹雨一ノ丨丨
蕾	艹雨丨ㄋ一一
藿	艹雨ノ丨一一
葛	艹曷丨ㄋㄋㄋ
蔓	艹日丨ㄋ丶丶
菜	艹爫一丨丶丶
荽	艹爫ㄋノ一一
莩	艹爫ㄋ丨一一
蕉	艹隹丶丶丶丶
蒹	艹兼丶ノ丶丶
芭	艹巴ㄋ丨ㄋㄋ
苏	艹力ノ丶丶丶
苯	艹木一一一一
茧	艹虫丨ㄋ丶丶
茁	艹出ㄋ丨丨丨
蔸	艹白ノ丨一一
茸	艹耳一丨一一
芳	艹方丶一ノノ
菲	艹非丨一一一
芙	艹夫一一丶丶
芾	艹一丨ㄋ丨丨
莆	艹甫一丨丶丶
苷	艹甘一丨一一
茛	艹艮ㄋ一丶丶
芎	艹弓ㄋ一ㄋㄋ
芦	艹户丶ㄋノノ
芨	艹及ノㄋ丶丶
芑	艹己ㄋ一ㄋㄋ
荚	艹夹ノ丶丶丶
葭	艹叚ㄋ一丶丶
芹	艹斤ノノ丨丨
艽	艹九ノㄋㄋㄋ
莱	艹夹丨ノ丶丶
茏	艹龙一ノ丶丶
茅	艹矛ㄋ丶ノノ
苠	艹民ㄋ一ㄋㄋ
茉	艹未一一丶丶
苜	艹目丨ㄋ一一
艿	艹乃ㄋノノノ
芮	艹内丨ㄋ丶丶
茶	艹人一丨丶丶
营	劳口丨ㄋ一一
荣	劳木一丨丶丶
苹	艹平一丶丨丨
芊	艹千ノ一丨丨
苴	艹且丨ㄋ一一
莽	艹犬一ノ丨丨
苒	艹冉丨ㄋ一一
芪	艹氏ノㄋㄋㄋ
蔑	萝戊丶丶丶丶
萝	萝夕ノㄋ丶丶
萧	艹肀ノ丶丨丨
苗	艹田丨ㄋ一一
芏	艹土一丨一一
芄	艹九丶丶丶丶
苇	艹韦一一丨丨
莪	艹我ノ一丶丶
芜	艹一一ノㄋㄋ
茂	艹戊一ノ丶丶
茜	艹西一丨一一
芗	艹乡ㄋㄋノノ
芯	艹心丶ㄋ丶丶
薰	艹千丨ㄋ丶丶
芽	艹牙一ㄋノノ
英	艹央丨ㄋ丶丶
荑	艹大ㄋ一ㄋㄋ
艺	艹乙ㄋㄋㄋㄋ
苡	艹以ㄋ丶丶丶
艾	艹乂ノ丶丶丶
芋	艹于一一丨丨
萸	艹臼ノ丶丶丶
苌	艹长ノ一丶丶
芝	艹之丶ㄋ丶丶
芷	艹止丨一一一
董	艹千丨ㄋ一一
萑	艹隹ノ丨一一
葎	艹彳ㄋ一丨丨
蕰	落日丨ㄋ一一
茀	艹弓ノ丨丨丨
蒐	艹鬼ノ丨丶丶
蒨	荷青一一一一
蔀	艹立丨ㄋ丨丨
萩	艹禾丶ノ丶丶
葰	荷夋ㄋ丶丶丶
苾	艹必丶ㄋ丶丶
葴	艹咸一ノ丶丶
蕗	艹ノㄋ一一
菍	艹今丶ㄋ丶丶
菉	艹录ㄋ一丶丶
蓇	艹骨丨ㄋ一一
蓏	艹瓜ノノ丶丶
薳	艹吉ノㄋ丶丶
茝	艹一丨一一
荄	艹亥丶一丶丶
苧	艹宀一丨丨丨
糵	艹丶一丶丶
菂	艹白ノㄋ丶丶
藠	艹白ノ丨一一
芃	艹凡ノㄋ丶丶
莿	艹朿丨丨丨丨
蓂	劳日丶一丶丶
荖	艹耂ノㄋㄋㄋ
藦	艹麻ノ一丨丨
葖	艹穴一ノ丶丶
蒟	艹立ノㄋ一一
茽	荷中丨ㄋ丨丨
蔊	艹火丨ㄋ丨丨
蒻	艹弓丶一一一
蘘	艹襄丶一丶丶
蒄	劳元一丨丶丶
萚	艹扌ㄋ丶丨丨
藨	艹鹿丶丶丶丶
芼	艹毛ノ一ㄋㄋ
荙	艹大丶ㄋ丶丶
莙	艹尹丨ㄋ一一
薁	艹向丶ノ丶丶
藟	艹田丨ㄋ一一
芠	艹文丶一丶丶
茓	艹穴丶丶丶丶
䓨	劳缶ノ一丨丨
䓫	艹大一丨丨丨
髹	髟亻一丨丶丶
鬏	髟禾丶ノ丶丶
髭	髟此丨一ㄋㄋ
鬓	髟宀ノ丨丶丶
鬃	髟宀一一丶丶
鬈	髟ㄋㄋㄋㄋ
髫	髟召ㄋノ一一
髻	髟吉一丨一一
鬟	髟罒丨ㄋ丶丶
髦	髟毛ノ一ㄋㄋ
髯	髟冉丨ㄋ一一
髡	髟兀一ノㄋㄋ
髟	髟一丨ノノ
肆	镸聿ㄋ一丨丨
鬣	髟巛丨ㄋㄋㄋ
鬘	髟日丨ㄋ丶丶
髽	髟从一丨一一
髢	髟也ㄋ丨ㄋㄋ
鬒	髟直ノ丶丶丶
赝	厂亻ノ丨丶丶
愿	厂白丨ノ丶丶
蜃	辰虫丨ㄋ丶丶
唇	辰口丨ㄋ一一
厩	厂一ㄋㄋㄋ
厕	厂贝丨丨丨丨
厮	厂其ノノ丨丨
雁	厂亻ノ丨一一
厨	厂豆一丨丶丶
厢	厂相一丨一一
厥	厂屰ノㄋ丶丶
原	厂白丨ノ丶丶
辰	辰一ノ丶丶
魇	厂犬ノ丨丶丶
厣	厂犬丨ㄋ丨丨
靥	厂犬一ノ一一
厘	厂里丨ㄋ一一
厚	厂日ㄋ丨一一
厦	厂丆丨ㄋ丶丶
厝	厂昔一丨一一
厍	厂车一ㄋ丨丨
历	厂力ㄋノノノ
厌	厂犬一ノ丶丶
仄	厂人ノ丶丶丶
压	厂土丶丶丶丶
厉	厂万一ㄋノノ
厄	厂㔾ㄋㄋㄋㄋ
辱	辰寸一丨丶丶
厂	厂一ノノノ
劂	厂屰ノㄋ丨丨
励	厂万ㄋノノノ
顾	厂㔾一ノノノ
餍	厂犬ノ丶丶丶
厅	厂丁一丨丨丨
黡	厂犬丨ㄋ丶丶
连	车辶丶ㄋ丶丶
錾	车斤ノ丶一一
椠	车斤一丨丶丶
暂	车斤丨ㄋ一一
堑	车斤一丨一一
车	车一ㄋ丨丨
辄	车耳ㄋㄋㄋㄋ
轶	车丿一一丶丶
轲	车可一丨丨丨
轫	车刀丶丶丶丶
轼	车弋一丨一一
辋	车冂丶ノㄋㄋ
辘	车鹿丶一ㄋㄋ
轭	车厂ㄋㄋㄋㄋ
辗	车尸一丨丶丶
软	车欠ノㄋ丶丶
轾	车至一ㄋ一一
辍	车双ㄋ丶丶丶
辖	车宀一一一一
较	车交丶一丶丶
辙	车丨ㄋ丶丶
轿	车夭ノ丨丨丨
辕	车土丨ㄋ丶丶
输	车俞ノ丶丨丨
轻	车轻ㄋ丶一一
辏	车ノ一丶丶
轮	车人ノㄋㄋㄋ
轳	车⺊ㄋ一ノノ
辎	车巛丨ㄋ一一
轺	车召ㄋノ一一
轵	车口ノ丶丶丶
辑	车口一丨一一
辚	车米ノㄋ丨丨
辊	车日一ㄋㄋㄋ
轸	车㐱ノ丶ノノ
轱	车十丨ㄋ一一
辁	车人一一一一
辐	车同丨ㄋ一一
辂	车各ノㄋ一一
辅	车甫一丨丶丶
轩	车干一一丨丨
轷	车乎ノ丶丨丨
斩	车斤ノノ丨丨
轨	车九ノㄋㄋㄋ
轹	车丨ノ丶丶
辆	车丙ノ丶丶丶
轧	车乚ㄋㄋㄋㄋ
轴	车由丨ㄋ一一
转	车专一一丶丶
轰	车双ㄋ丶丶丶
辀	车舟ノノ丶丶
辌	车京丶一丶丶
辒	车日丨ㄋ一一
轪	车大一ノ丶丶
墼	車凵ノㄋ一一
軎	車口丨ㄋ一一
蚩	蚩ㄋ丨丶丶
臣	臣一丨ㄋㄋ
卧	臣卜丨丶丶丶
惩	彳正丶ㄋ丶丶
後	彳幺ノㄋ丶丶
徼	彳白丶一丶丶
徽	微糸ㄋㄋ丶丶
御	彳丨一丨丨
德	彳十丨ㄋ丶丶
彻	彳七ㄋノノノ
徇	彳勹丨ㄋ一一
徊	彳回丨ㄋ一一
循	彳一丨一一
徐	彳余ノ丶丶丶
径	彳轻ㄋ丶一一
徜	彳尚丨丶一一
徨	彳白一一一一
往	彳主丶一一一
役	彳殳ノㄋ丶丶
徵	微壬ノ一丶丶
微	微几ノ一丶丶
衡	彳丨ㄋ丨丨
待	彳土一丨丶丶
徒	彳走一丨丶丶
衢	彳目丨ㄋ丨丨
街	彳圭一一丨丨
衙	彳五丨ㄋ丨丨
行	彳亍一一丨丨
衔	彳钅一一丨丨
征	彳正一丨一一
得	彳旦一丨丶丶
徭	彳爫ノ一丨丨
徙	彳止丨一丶丶
彷	彳方丶一ノノ
徘	彳非丨一一一
很	彳艮ㄋ一丶丶
徕	彳夹丨ノ丶丶
彼	彳皮ㄋノ丶丶
徂	彳且丨ㄋ一一
衍	彳氵一一丨丨
徉	彳羊丶ノ丨丨
律	彳聿ㄋ一丨丨
愆	彳氵一一丶丶
鸻	彳亍ノㄋ一一
衒	彳亠ㄋㄋ丨丨
衎	彳干一一丨丨
衠	彳直ノ丶丨丨
徛	彳大一丨丨丨
虫	虫丨ㄋ丶丶
蚵	虫丁丨ㄋ一一
蠛	虫萝一ノ丶丶
螓	虫ノ一丶丶
蟓	虫象ノㄋ丶丶
螂	虫朗ㄋ丨丨丨
蝴	虫古ノㄋ一一
蟛	虫壴ノノノノ
蛳	虫一丨丨丨
蚍	虫比一ㄋㄋㄋ
蝣	虫族ㄋ丨一一
蚓	虫弓丨丨丨丨
#蜊	虫禾丨丨丨丨
蝌	虫禾丶丶丨丨
蜥	虫木ノノ丨丨
蛛	虫丿一一丶丶
蜘	虫矢丨ㄋ一一
蚴	虫幺ㄋノノノ
蜮	虫戈丨ㄋ一一
蜒	虫丿丨一丶丶
蜓	虫壬ㄋ丶丶丶
蚬	虫见丨ㄋㄋㄋ
蜩	虫冂一丨一一
蛔	虫回丨ㄋ一一
蝈	虫囗一一丶丶
蟾	虫厃ノ丶一一
螈	虫厂ノ丨丶丶
蛎	虫厂一ㄋノノ
螗	虫广ㄋ一一一
蠊	虫广丶ノ丶丶
蝙	虫户丨ㄋ丨丨
蜣	虫羊ノㄋㄋㄋ
蚁	虫丶ノ丶丶丶
蜱	虫卑ノ丨丨丨
螬	虫曹一丨一一
蟪	虫惠丶ㄋ丶丶
蜞	虫其一丨丶丶
蟮	虫羊丶ノ一一
蛲	虫尧一ㄋㄋㄋ
蛭	虫至一ㄋ一一
蠼	虫目丨ㄋ丶丶
螭	虫㐫丨ㄋ丶丶
螃	虫帝丶一ノノ
螳	虫一丨一一
蛉	虫令ノ丶丶丶
蜿	虫宀ノㄋㄋㄋ
蛇	虫宀ノㄋㄋㄋ
虻	虫亡丶一ㄋㄋ
蛟	虫交丶一丶丶
蟠	虫番ノ丶一一
蟋	虫丿丶ノ丶丶
蝓	虫俞ノ丶丨丨
蛤	虫合ノ丶一一
蜍	虫余ノ丶丶丶
蚧	虫人ノ丨丨丨
蝮	虫复ノ一丶丶
虼	虫ㄋㄋㄋㄋ
蛸	虫肖丨丶一一
蜻	虫青一一一一
蝽	虫丨ㄋ一一
蜷	虫ㄋㄋㄋㄋ
蚣	虫公ノ丶丶丶
蝉	虫单丶ノ丨丨
蜕	虫总ノㄋㄋㄋ
蝤	虫酋丶ノ一一
蝗	虫白一一一一
蠓	虫劳一一丶丶
蟆	虫莫一丨丶丶
蠖	虫艹ノ丨丶丶
螨	虫艹一丨丶丶
蟒	虫艹一ノ丨丨
蝰	虫大一丨一一
蛀	虫主丶一一一
蜈	虫口一一丶丶
蝇	虫口丨ㄋㄋㄋ
蜗	虫呙丨ㄋ丶丶
蟑	虫音一丨丨丨
蝼	虫米ㄋノ一一
蟥	虫丨ㄋ丶丶
螟	虫冖丨ㄋ丶丶
蛞	虫舌ノ一一一
蜴	虫日ノㄋノノ
蝻	虫十丨ㄋ丨丨
蛄	虫古一丨一一
蝶	虫世一丨丶丶
蛑	虫厶ノ一丨丨
螺	虫田ㄋㄋ丶丶
蛙	虫圭一丨一一
蛴	虫文ノ丨丨丨
螵	虫覀一一丶丶
蝠	虫同丨ㄋ一一
螋	虫臼丨ㄋ丶丶
蛏	虫又一丨一一
蠕	虫雨一ノ丨丨
蝎	虫曷丨ㄋㄋㄋ
蜉	虫爫ㄋ丨一一
蜂	虫夂一一丨丨
蜢	虫子丨ㄋ一一
螅	虫自丶ㄋ丶丶
蛹	虫甬ㄋ丶丨丨
蜡	虫昔一丨一一
蚪	虫⺀一丨丨丨
蚌	虫丰一一丨丨
蚨	虫夫一一丶丶
蚶	虫甘一丨一一
虹	虫工一丨一一
蜾	虫日一丨丶丶
虮	虫几ノㄋㄋㄋ
蛱	虫夹ノ丶丶丶
蟀	虫玄丶一丨丨
蚂	虫马ㄋㄋ一一
蚝	虫毛ノ一ㄋㄋ
蚋	虫内丨ㄋ丶丶
蛆	虫且丨ㄋ一一
蚯	虫丘ノ丨一一
蛐	虫曲丨ㄋ一一
蚺	虫冉丨ㄋ一一
蚊	虫文丶一丶丶
蛾	虫我ノ一丶丶
虾	虫下一丨丶丶
蚜	虫牙一ㄋノノ
蛘	虫羊丶ノ丨丨
虬	虫乚ㄋㄋㄋㄋ
蚰	虫由丨ㄋ一一
蚱	虫乍ノ一一一
蝾	虫劳一丨丶丶
蛊	虫皿丨ㄋ一一
蠋	虫罒ノㄋ丶丶
蟫	虫覀丨ㄋ丨丨
蝘	虫匚丨ㄋ一一
蜎	虫口丨ㄋ一一
蜐	虫去ㄋノノノ
螠	虫䒑ノ丶一一
蚄	虫方丶一ノノ
虸	虫子ㄋ丨一一
虷	虫干一一丨丨
丑	丑ㄋ丨一一
亍	亍一一丨丨
州	川丶丶丶丶
川	川ノ丨丨丨
顺	川页一ノ丶丶
巡	巛辶丶ㄋ丶丶
剿	巛日一丨丨丨
邋	巛囗ノ丶丶丶
邕	巛口ㄋ丨ㄋㄋ
巢	巛日一丨丶丶
甾	巛田丨ㄋ一一
垂	垂ノ一一一
过	寸辶丶ㄋ丶丶
寸	寸一丨丶丶
达	大辶丶ㄋ丶丶
太	大丶丶丶丶丶
态	大丶丶ㄋ丶丶
大	大一ノ丶丶
爽	大爻ノ丶丶丶
夷	大弓ㄋ一ㄋㄋ
欹	大可ノㄋ丶丶
剞	大可丨丨丨丨
匏	大亏ノㄋㄋㄋ
刳	大亏丨丨丨丨
瓠	大亏ノノ丶丶
鹌	大日ㄋノ一一
奁	大区一ノㄋㄋ
奇	大可一丨丨丨
奢	大者一丨一一
夸	大亏一一ㄋㄋ
奔	大十一ノ丨丨
奎	大圭一丨一一
套	大镸一丨丶丶
夼	大川ノ丨丨丨
夺	大寸一丨丶丶
奄	大日ㄋㄋㄋㄋ
耷	大耳一丨一一
夯	大力ㄋノノノ
牵	大冖ノ一丨丨
奈	大示一一丶丶
奋	大田丨ㄋ一一
奓	大夕ノㄋ丶丶
死	歹匕ノㄋㄋㄋ
裂	歹刂丶一丶丶
烈	歹刂丶丶丶丶
歹	歹一ノ丶丶
殊	歹丿一一丶丶
殉	歹勹丨ㄋ一一
殡	歹宀ノ丨丶丶
殓	歹佥ノ丶一一
殇	歹ㄋノノノ
殚	歹单丶ノ丨丨
殁	歹殳ノㄋ丶丶
殒	歹口丨ㄋ丶丶
殄	歹㐱ノ丶ノノ
殖	歹直一丨一一
殪	歹壳一丨一一
殆	歹台ㄋ丶一一
殍	歹爫ㄋ丨一一
列	歹刂丨丨丨丨
殛	歹了丨ㄋ一一
残	歹戋一一丶丶
歼	歹千ノ一丨丨
殂	歹且丨ㄋ一一
殃	歹央丨ㄋ丶丶
餮	歹㐱ノ丶丶丶
佞	亻二ㄋノ一一
您	亻尔丶ㄋ丶丶
煲	华口丶ノ丶丶
堡	华口一丨一一
赁	亻壬丨ㄋ丶丶
凭	亻壬ノㄋㄋㄋ
恁	亻壬丶ㄋ丶丶
货	亻七丨ㄋ丶丶
华	华七ノㄋㄋㄋ
垡	亻戈一丨一一
贷	代贝丨ㄋ丶丶
袋	代衣丶一丶丶
黛	代黑丨ㄋ丶丶
牮	代牛ノ一丨丨
岱	代山丨ㄋ丨丨
佧	亻上丨丶丶丶
鸺	亻木ノㄋ一一
攸	攸攵ノ一丶丶
侯	亻ノ一丶丶
偃	亻匚丨ㄋ一一
伛	亻区一ノㄋㄋ
佬	亻耂ノㄋㄋㄋ
侧	亻贝丨丨丨丨
倒	亻至丨丨丨丨
僦	亻京一ノ丶丶
傲	亻敖一一丶丶
儆	亻芍ノㄋ丶丶
僻	亻辟ㄋ一丨丨
做	亻古ノ一丶丶
仰	亻ㄋ丨丨丨
仳	亻比一ㄋㄋㄋ
倾	亻一ノ丶丶
例	亻歹丨丨丨丨
俐	亻禾丨丨丨丨
伽	亻加ㄋノ一一
佚	亻丿一一丶丶
侏	亻丿一一丶丶
候	攸ノ一丶丶
倏	攸夂一ノ丶丶
储	亻讠一丨一一
傩	亻又ノ丨一一
伺	亻丨ㄋ一一
何	亻可一丨丨丨
佝	亻句ノㄋ一一
仞	亻刀丶丶丶丶
健	亻聿ㄋ丶丶丶
佩	亻几一丨丨丨
倜	亻冂一丨一一
侗	亻冂丨ㄋ一一
儋	亻厃ノ丶一一
俦	亻一丨丶丶
佐	亻一丨一一
俯	亻广ノ丨丶丶
偏	亻户丨ㄋ丨丨
佑	亻丨ㄋ一一
倨	亻尸一丨一一
伲	亻尸ノㄋㄋㄋ
倔	亻尸ㄋ丨丨丨
仪	亻丶ノ丶丶丶
俾	亻卑ノ丨丨丨
你	亻尔ノㄋ丶丶
俱	亻ノ丶丶丶
俗	亻谷ノ丶一一
侥	亻尧一ㄋㄋㄋ
侄	亻至一ㄋ一一
傺	亻祭ノㄋ丶丶
偕	亻比ノ丨一一
僭	亻旡一ㄋ一一
傻	亻囟ノ丶丶丶
倥	亻穴一丨一一
傍	亻帝丶一ノノ
停	亻亮一丨丨丨
偿	亻丶ㄋ丶丶
傥	亻ノㄋㄋㄋ
伶	亻令ノ丶丶丶
傧	亻宀ノ丨丶丶
佗	亻宀ノㄋㄋㄋ
伫	亻㝉丶丶一一
倌	亻宀丨ㄋ一一
依	亻衣丶一丶丶
佼	亻交丶一丶丶
伉	亻亠ノㄋㄋㄋ
侩	亻人一一丶丶
侨	亻夭ノ丨丨丨
偾	亻十一丨丶丶
僖	亻壴丨ㄋ一一
偷	亻俞ノ丶丨丨
俭	亻佥ノ丶一一
僵	亻一丨ㄋ一一
僚	亻尞一ノ丶丶
价	亻人ノ丨丨丨
伤	亻ㄋノノノ
侮	亻每ノ一丶丶
仵	亻一丨丨丨
仡	亻ㄋㄋㄋㄋ
像	亻象ノㄋ丶丶
俏	亻肖丨丶一一
倘	亻尚丨丶一一
倩	亻青一一一一
俸	亻一一丨丨
傣	亻丨丶丶丶
倦	亻ㄋㄋㄋㄋ
佾	亻八丨ㄋ一一
份	亻分ノ丶ノノ
僧	亻曾丶ノ一一
伦	亻人ノㄋㄋㄋ
侦	亻⺊丨ㄋ丶丶
倬	亻卓丨一丨丨
偌	亻艹一ノ一一
偬	亻勿丶丶丶丶
倚	亻大一丨丨丨
侉	亻大一一ㄋㄋ
俺	亻大丨ㄋㄋㄋ
住	亻主丶一一一
傅	亻甫一丨丶丶
倭	亻禾ㄋノ一一
侵	亻彐丶ㄋ丶丶
倪	亻臼ノㄋㄋㄋ
俣	亻口一一丶丶
侃	亻口ノ丨ㄋㄋ
侣	亻口丨ㄋ一一
保	华口丨ㄋ一一
促	亻足丨ㄋ丶丶
僮	亻立丨ㄋ一一
倍	亻立丨ㄋ一一
偻	亻米ㄋノ一一
任	亻壬ノ一一一
仫	亻丿ㄋ丶丶丶
但	亻旦丨ㄋ一一
倡	亻日丨ㄋ一一
催	亻山ノ丨一一
值	亻直一丨一一
估	亻古一丨一一
伎	亻十ㄋ丶丶丶
佶	亻吉一丨一一
低	亻氏丶丶丶丶
俊	亻夋ㄋ丶丶丶
侔	亻厶ノ一丨丨
俟	亻厶ノ一丶丶
儇	亻同ノㄋ丶丶
儡	亻田丨ㄋ一一
俚	亻里丨ㄋ一一
偎	亻田一ㄋ丶丶
侍	亻土一丨丶丶
佳	亻圭一丨一一
侪	亻文ノ丨丨丨
侈	亻夕ノㄋ丶丶
僳	亻覀丶ノ丶丶
傈	亻覀一丨丶丶
伧	亻仓ノ丶ㄋㄋ
俪	亻丽一丨丶丶
佰	亻百一ノ一一
俜	亻由一ㄋㄋㄋ
儒	亻雨一ノ丨丨
偈	亻曷丨ㄋㄋㄋ
侑	亻丨ㄋ一一
俘	亻爫ㄋ丨一一
佟	亻夂丶丶丶丶
僬	亻隹丶丶丶丶
俑	亻甬ㄋ丶丨丨
债	亻丨ㄋ丶丶
供	亻共一丨丶丶
借	亻昔一丨一一
化	亻七一ㄋㄋㄋ
伯	亻白ノ丨一一
伴	亻半丶ノ丨丨
体	亻木一一一一
仆	亻卜丨丶丶丶
付	付ノ丨丶丶
仃	亻丁一丨丨丨
佴	亻耳一丨一一
仁	亻二一一一一
仿	亻方丶一ノノ
俳	亻非丨一一一
佛	亻弓ノ丨丨丨
伐	亻戈一ㄋ丶丶
便	亻更一丨丶丶
傀	亻鬼ノ丨丶丶
倮	亻日一丨丶丶
伙	亻火丶ノ丶丶
仉	亻几ノㄋㄋㄋ
侠	亻夹ノ丶丶丶
假	亻叚ㄋ一丶丶
仇	亻九ノㄋㄋㄋ
仂	亻力ㄋノノノ
位	亻立丶一一一
使	亻同ノ丶丶丶
俩	亻丙ノ丶丶丶
们	亻门丶丨ㄋㄋ
休	亻木一丨丶丶
仍	亻乃ㄋノノノ
件	亻牛ノ一丨丨
侬	亻农丶ㄋノノ
仟	亻千ノ一丨丨
俅	亻求一丨丶丶
伏	亻犬一ノ丶丶
仨	亻三一一一一
仙	亻山丨ㄋ丨丨
伸	亻日丨丨丨丨
什	亻十一丨丨丨
仕	亻士一丨一一
修	攸夂ノノノノ
佃	亻田丨ㄋ一一
佤	亻瓦一ㄋ丶丶
伟	亻韦一一丨丨
伪	亻为丶ノ丶丶
俄	亻我ノ一丶丶
伍	亻五一丨一一
伢	亻牙一ㄋノノ
俨	亻亚ノノノノ
信	亻言丶一一一
佯	亻羊丶ノ丨丨
他	亻也ㄋ丨ㄋㄋ
亿	亻乙ㄋㄋㄋㄋ
似	亻以ㄋ丶丶丶
代	代ノ丨丶丶
伊	亻尹ㄋ一ノノ
佣	亻用ノㄋ丨丨
优	亻尢丶丶丶丶
仅	亻又ㄋ丶丶丶
偶	亻禺丨ㄋ丶丶
作	亻乍ノ一一一
伥	亻长ノ一丶丶
仗	亻丶丶丶丶
佻	亻儿丶一丶丶
仲	亻中丨ㄋ丨丨
传	亻专一一丶丶
仔	亻子ㄋ丨一一
悠	攸攵丶ㄋ丶丶
脩	攸攵ノㄋ一一
翛	攸夂ㄋ丶一一
伈	亻心丶ㄋ丶丶
伋	亻及ノㄋ丶丶
伣	亻见丨ㄋㄋㄋ
伭	亻亠ㄋㄋ丶丶
佖	亻必丶ㄋ丶丶
侹	亻壬ㄋ丶丶丶
俙	亻希ノ丶丨丨
俫	亻夹丨ノ丶丶
俵	亻ノㄋ丶丶
倞	亻京丶一丶丶
偰	亻丰ㄋノ丶丶
傒	亻爫ㄋㄋ丶丶
傕	亻冖ノ丨一一
僇	亻羽ノ丶ノノ
儦	亻鹿丶丶丶丶
儴	亻襄丶一丶丶
阻	阝且丨ㄋ一一
旦	旦丨ㄋ一一
刃	刀丶丶丶丶丶
迢	召辶丶ㄋ丶丶
忍	刀丶丶ㄋ丶丶
刀	刀ㄋノノノ
劭	召力ㄋノノノ
邵	召阝ㄋ丨丨丨
召	召ㄋノ一一
昶	永日丨ㄋ一一
义	丶乂ノ丶丶丶
为	为丶ノ丶丶
户	户丶ㄋノノ
永	永丶ㄋ丶丶
朗	朗月ノㄋ一一
郎	朗阝ㄋ丨丨丨
良	良丶ㄋ丶丶
丁	丁一丨丨丨
顶	丁页一ノ丶丶
逗	豆辶丶ㄋ丶丶
豌	豆宀ノㄋㄋㄋ
豉	豆十ㄋ丶丶丶
豇	豆工一丨一一
逃	儿丶ㄋ丶丶
鼗	儿一丨丶丶
儿	儿ノㄋㄋㄋ
兆	儿丶一丶丶
鸸	而鸟ノㄋ一一
耐	而寸一丨丶丶
耍	而女ㄋノ一一
恧	而心丶ㄋ丶丶
娶	耳又ㄋノ一一
聚	耳又ノ丨丶丶
耳	耳一丨一一
鄹	耳又ノ丨丨丨
颞	耳双一ノ丶丶
聊	耳卯ㄋ丨丨丨
聩	耳贵丨ㄋ丶丶
聆	耳令ノ丶丶丶
聍	耳宀一丨丨丨
联	耳䒑一ノ丶丶
聪	耳总丶ㄋ丶丶
职	耳口ノ丶丶丶
聒	耳舌ノ一一一
聘	耳由一ㄋㄋㄋ
耵	耳丁一丨丨丨
耿	耳火丶ノ丶丶
聃	耳冉丨ㄋ一一
耽	耳冖ノㄋㄋㄋ
取	耳又ㄋ丶丶丶
耻	耳止丨一一一
耶	耳阝ㄋ丨丨丨
聂	耳双ㄋ丶丶丶
运	云辶丶ㄋ丶丶
辇	夫夫一ㄋ丨丨
替	夫夫丨ㄋ一一
击	凵ㄋ丨丨丨
二	二一一一一
专	专一一丶丶
未	未一一丶丶
夫	夫一一丶丶
井	井一一丨丨
魂	云鬼ノ丨丶丶
动	云力ㄋノノノ
规	夫见丨ㄋㄋㄋ
云	云一一丶丶
鬶	夫见一丨丨丨
狰	犭争ノㄋ丨丨
逖	犭火丶ㄋ丶丶
逛	犭王丶ㄋ丶丶
橥	犭者一丨丶丶
猓	犭日一丨丶丶
猸	犭丨ㄋ一一
猢	犭古ノㄋ一一
狮	犭一丨丨丨
猴	犭亻ノ丨丶丶
猕	犭弓ノㄋ丶丶
猁	犭禾丨丨丨丨
獬	犭角ㄋノ丨丨
獭	犭束ノㄋ丶丶
狗	犭句ノㄋ一一
狍	犭勹ㄋ一ㄋㄋ
狨	犭戈一ノノノ
狈	犭贝丨ㄋ丶丶
獗	犭厂丶ノ丶丶
猪	犭者一丨一一
狴	犭比一丨一一
狩	犭宀一丨丶丶
狞	犭宀一丨丨丨
狡	犭交丶一丶丶
狯	犭人一一丶丶
獍	犭音ノㄋㄋㄋ
猿	犭吉ノㄋ丶丶
猞	犭舍ノ丶一一
猃	犭佥ノ丶一一
狳	犭余ノ丶丶丶
獠	犭尞一ノ丶丶
猾	犭骨丨ㄋ一一
猜	犭青一一一一
猫	犭艹丨ㄋ一一
獾	犭艹丨ㄋ一一
猗	犭大一丨丨丨
狼	犭良丶ㄋ丶丶
猊	犭臼ノㄋㄋㄋ
狷	犭口丨ㄋ一一
獐	犭音一丨丨丨
猱	犭矛一丨丶丶
猹	犭木丨ㄋ一一
猩	犭日ノ一一一
猖	犭日丨ㄋ一一
猝	犭卒丶一丨丨
狁	犭厶ノㄋㄋㄋ
猡	犭罒ノㄋ丶丶
猬	犭田丨ㄋ一一
狸	犭里丨ㄋ一一
猥	犭田一ㄋ丶丶
狻	犭夋ㄋ丶丶丶
猛	犭子丨ㄋ一一
猎	犭昔一丨一一
独	犭虫丨ㄋ丶丶
狃	犭丑ㄋ丨一一
狒	犭弓ㄋ一ㄋㄋ
犴	犭干一一丨丨
狠	犭艮ㄋ一丶丶
狐	犭瓜ノノ丶丶
犷	犭广丶一ノノ
狄	犭火丶ノ丶丶
狭	犭夹ノ丶丶丶
狎	犭甲丨ㄋ丨丨
犰	犭九ノㄋㄋㄋ
犸	犭马ㄋㄋ一一
狙	犭且丨ㄋ一一
狂	犭王一一一一
犯	犭㔾ㄋㄋㄋㄋ
獯	犭千丨ㄋ丶丶
狱	犭讠一ノ丶丶
狺	犭言丶一一一
犹	犭尢丶丶丶丶
狲	犭孑丨ノ丶丶
㺄	犭俞ノ丶丨丨
猄	犭京丶一丶丶
猇	犭虍ノㄋㄋㄋ
猯	犭山一ノ丨丨
猰	犭丰ㄋノ丶丶
慝	匚艹一ノ丶丶
翳	匚矢ノㄋ一一
匦	匚车ノㄋㄋㄋ
匾	匚户丨ㄋ丨丨
匮	匚贵丨ㄋ丶丶
匿	匚艹一ノ一一
巨	匚ㄋ一一一
匹	匚儿ノㄋㄋㄋ
匪	匚非丨一一一
匣	匚甲丨ㄋ丨丨
匝	匚巾丨ㄋ丨丨
匠	匚斤ノノ丨丨
叵	匚口丨ㄋ一一
医	匚矢ノ一丶丶
匡	匚王一一一一
区	区一ノㄋㄋ
郾	匚日ㄋノ丨丨
鸥	区鸟ノㄋ一一
欧	区欠ノㄋ丶丶
殴	区殳ノㄋ丶丶
瓯	区瓦一ㄋ丶丶
繄	匚矢ノㄋ丶丶
匼	匚合ノ丶一一
方	方丶一ノノ
於	方人丶丶丶丶
放	方攵ノ一丶丶
邡	方阝ㄋ丨丨丨
旞	族㒸丶ㄋ丶丶
非	非丨一一一
韭	非一一一一一
翡	非羽ㄋ丶一一
裴	非衣丶一丶丶
辈	非车一ㄋ丨丨
蜚	非虫丨ㄋ丶丶
斐	非文丶一丶丶
悲	非心丶ㄋ丶丶
贫	分贝丨ㄋ丶丶
盆	分皿丨ㄋ一一
岔	分山丨ㄋ丨丨
坌	分土一丨一一
忿	分心丶ㄋ丶丶
分	分ノ丶ノノ
颁	分页一ノ丶丶
邠	分阝ㄋ丨丨丨
攽	分攵ノ一丶丶
契	丰刀一ノ丶丶
挈	丰刀ノ一丨丨
恝	丰刀丶ㄋ丶丶
彗	丰丰ㄋ一一一
慧	丰丰ㄋ一丶丶
丰	丰一一丨丨
艳	丰ㄋ丨ㄋㄋ
砉	丰石一ノ一一
絜	丰刀ㄋㄋ丶丶
缶	缶ノ一丨丨
罅	缶虍ノ丶丨丨
罐	缶艹丨ㄋ一一
缸	缶工一丨一一
缺	缶夬ㄋ一丶丶
逋	甫辶丶ㄋ丶丶
甫	甫一丨丶丶
敷	甫方ノ一丶丶
甘	甘一丨一一
邯	甘阝ㄋ丨丨丨
某	甘木一丨丶丶
干	干一一丨丨
刊	干刂丨丨丨丨
顸	干页一ノ丶丶
邗	干阝ㄋ丨丨丨
或	戈口一一一一
戒	戈廾一ノ丨丨
戎	戈一ノノノ
惑	戈口一丶丶丶
戈	戈一ㄋ丶丶
划	戈刂丨丨丨丨
靴	革亻ノㄋㄋㄋ
鞭	革亻一丨丶丶
鞠	革勹丶ノ丶丶
鞫	革勹丶一一一
鞑	革大丶ㄋ丶丶
鞍	革宀ㄋノ一一
鞒	革夭ノ丨丨丨
鞔	革免ノㄋㄋㄋ
鞘	革肖丨丶一一
鞯	革艹一ノ一一
鞣	革矛一丨丶丶
鞲	革冓一一一一
靼	革旦丨ㄋ一一
鞋	革圭一丨一一
鞴	革ノノ丨丨
靶	革巴ㄋ丨ㄋㄋ
靳	革斤ノノ丨丨
勒	革力ㄋノノノ
鞅	革央丨ㄋ丶丶
革	革一丨丨丨
鞬	革聿ㄋ丶丶丶
鞮	革是丨ㄋ丶丶
靸	革及ノㄋ丶丶
靰	革兀一ノㄋㄋ
鞡	革扌丶一一一
靿	革幺ㄋノノノ
靺	革末一一丶丶
鞨	革曷丨ㄋㄋㄋ
鞧	革酋丶ノ一一
韂	革厃ノ丶一一
艮	艮ㄋ一丶丶
退	艮辶丶ㄋ丶丶
垦	艮土一丨一一
恳	艮心丶ㄋ丶丶
蛩	工凡丨ㄋ丶丶
銎	工凡ノ丶一一
恐	工凡丶ㄋ丶丶
工	工一丨一一
巫	工从ノ丶丶丶
跫	工凡丨ㄋ丶丶
巩	工凡ノㄋ丶丶
攻	工攵ノ一丶丶
巧	工丂一ㄋㄋㄋ
功	工力ㄋノノノ
项	工页一ノ丶丶
邛	工阝ㄋ丨丨丨
觋	工从丨ㄋㄋㄋ
贡	工贝丨ㄋ丶丶
汞	工水丨ㄋ丶丶
鹀	工从ノㄋ一一
犟	弓口丨ㄋ丨丨
鬻	弓米ㄋ一丨丨
弗	弓ノ丨丨丨
弓	弓ㄋ一ㄋㄋ
弪	弓轻ㄋ丶一一
疆	弓土一一一一
弱	弓冫ㄋ一一一
艴	弓ノㄋㄋㄋ
弥	弓尔ノㄋ丶丶
弦	弓玄丶一丶丶
弹	弓单丶ノ丨丨
强	弓口丨ㄋ丶丶
弼	弓百ㄋ一ㄋㄋ
弭	弓耳一丨一一
弧	弓瓜ノノ丶丶
粥	弓米ㄋ一ㄋㄋ
引	弓丨丨丨丨丨
弘	弓厶ㄋ丶丶丶
弛	弓也ㄋ丨ㄋㄋ
张	弓长ノ一丶丶
费	弓丨ㄋ丶丶
弶	弓京丶一丶丶
廾	廾一ノ丨丨
鹕	古月ノㄋ一一
兢	古儿一丨ㄋㄋ
鸪	古鸟ノㄋ一一
故	古攵ノ一丶丶
嘏	古叚ㄋ一丶丶
胡	古月ノㄋ一一
辜	古辛丶一丨丨
克	古儿ノㄋㄋㄋ
古	古一丨一一
骨	骨丨ㄋ一一
鹘	骨鸟ノㄋ一一
髓	骨一丨丶丶
骺	骨丨ㄋ一一
髀	骨卑ノ丨丨丨
髌	骨宀ノ丨丶丶
髂	骨宀ノㄋ一一
髋	骨宀一丨ㄋㄋ
骸	骨亥丶一丶丶
骱	骨人ノ丨丨丨
骰	骨殳ノㄋ丶丶
髅	骨米ㄋノ一一
骷	骨古一丨一一
骶	骨氏丶丶丶丶
髑	骨罒ノㄋ丶丶
骼	骨各ノㄋ一一
髁	骨日一丨丶丶
髃	骨禺丨ㄋ丶丶
髎	骨羽ノ丶ノノ
瓞	瓜丿一一丶丶
瓜	瓜ノノ丶丶
贯	毌贝丨ㄋ丶丶
遮	度灬丶ㄋ丶丶
赓	广彐ノ丶丶丶
腐	广付丨ㄋ丶丶
麽	麻丿ㄋ丶丶丶
魔	麻鬼ノ丨丶丶
麾	麻毛ノ一ㄋㄋ
糜	麻米丶ノ丶丶
磨	麻石一ノ一一
摩	麻手ノ一丨丨
疳	广甘一丨一一
庚	广彐ノ丶丶丶
庸	广肀ノㄋ一一
廊	广朗ㄋ丨丨丨
廓	广享ㄋ丨丨丨
廒	广敖一一丶丶
庇	广比一ㄋㄋㄋ
府	广付ノ丨丶丶
庥	广亻一丨丶丶
廨	广角ㄋノ丨丨
麻	麻丶一丶丶
庖	广勹ㄋ一ㄋㄋ
庭	广壬ㄋ丶丶丶
废	广发ㄋノ丶丶
膺	广亻ノ丨一一
鹰	广亻ノ丨一一
廖	广羽ノ丶ノノ
廪	广亠丨ㄋ丶丶
廛	广里ノ丶一一
应	广兴丶丶一一
店	广占丨一一一
庵	广大丨ㄋㄋㄋ
廑	广堇一丨一一
庹	度尺ㄋ一丶丶
庶	度灬丶丶丶丶
席	度巾丨ㄋ丨丨
度	度又ㄋ丶丶丶
唐	广肀丨ㄋ一一
庋	广十ㄋ丶丶丶
底	广氏丶丶丶丶
库	广车一ㄋ丨丨
庆	广大一ノ丶丶
庐	广户丶ㄋノノ
康	广隶ㄋ一丶丶
庞	广龙一ノ丶丶
床	广木一丨丶丶
庄	广土一丨一一
庑	广一一ノㄋㄋ
庠	广羊丶ノ丨丨
庾	广臼ノ丶丶丶
座	广从一丨一一
广	广丶一ノノ
庀	广匕ノㄋㄋㄋ
鹧	度灬ノㄋ一一
邝	广阝ㄋ丨丨丨
縻	麻糸ㄋㄋ丶丶
靡	麻非丨一一一
庳	广卑ノ丨丨丨
廉	广兼丶ノ丶丶
庙	广由丨ㄋ一一
序	广予ㄋ丶丨丨
鄘	广肀ノㄋ丨丨
鹒	广彐ノ丶一一
庱	广土ノ丶丶丶
廆	广鬼ノ丨丶丶
魈	鬼肖丨丶一一
魃	鬼ㄋ丶丶丶
魁	鬼⺀一丨丨丨
魉	鬼丙ノ丶丶丶
魅	鬼未一一丶丶
魍	鬼冂丶ノㄋㄋ
魑	鬼㐫丨ㄋ丶丶
魆	鬼戉一ㄋ丶丶
魋	鬼隹ノ丨一一
遗	贵辶丶ㄋ丶丶
遣	中一丨ㄋ丶丶
贵	贵丨ㄋ丶丶
亥	亥丶一丶丶
刻	亥刂丨丨丨丨
劾	亥力ㄋノノノ
颏	亥页一ノ丶丶
黏	禾人丨丶一一
透	禾乃丶ㄋ丶丶
逶	禾女丶ㄋ丶丶
黎	禾勹ノ丨丶丶
黧	禾勹ノ丨丶丶
梨	禾刂一丨丶丶
犁	禾刂ノ一丨丨
愁	禾火丶ㄋ丶丶
乘	禾北丨一ㄋㄋ
秉	禾彐ㄋ一一一
禾	禾ノ一丶丶
黍	禾人丨丶丶丶
颓	禾几一ノ丶丶
魏	禾女ノ丨丶丶
馥	禾日ノ一丶丶
剩	禾北丨丨丨丨
秕	禾比一ㄋㄋㄋ
秩	禾丿一一丶丶
秫	禾木丶丶丶丶
稿	禾高丶一一一
稠	禾冂一丨一一
稗	禾卑ノ丨丨丨
称	禾尔ノㄋ丶丶
穗	禾惠丶ㄋ丶丶
穑	禾十丶ノ一一
稔	禾今丶ㄋ丶丶
稳	禾刍丶ㄋ丶丶
稼	禾宀一ノ丶丶
穰	禾襄丶一丶丶
稍	禾肖丨丶一一
税	禾总ノㄋㄋㄋ
穆	禾白丨ノ丶丶
稂	禾良丶ㄋ丶丶
积	禾口ノ丶丶丶
稆	禾口丨ㄋ一一
程	禾口一一一一
秽	禾山ノㄋ丶丶
稹	禾直ノ丶丶丶
秸	禾吉一丨一一
稷	禾田ノ丶丶丶
稀	禾希ノ丶丨丨
移	禾夕ノㄋ丶丶
秒	禾小ノノノノ
稽	禾尢丶ノ一一
嵇	禾尢丶丨丨丨
稻	禾爫ノ丨一一
稃	禾爫ㄋ丨一一
秭	禾弟ノㄋノノ
秘	禾必丶ㄋ丶丶
利	禾刂丨丨丨丨
科	禾⺀一丨丨丨
秆	禾干一一丨丨
稞	禾日一丨丶丶
秋	禾火丶ノ丶丶
和	禾口丨ㄋ一一
秣	禾未一一丶丶
秤	禾平一丶丨丨
租	禾且丨ㄋ一一
私	禾厶ㄋ丶丶丶
秧	禾央丨ㄋ丶丶
种	禾中丨ㄋ丨丨
稚	禾隹ノ丨一一
秃	禾几ノㄋㄋㄋ
秀	禾乃ㄋノノノ
委	禾女ㄋノ一一
香	禾日丨ㄋ一一
季	禾子ㄋ丨一一
秾	禾农丶ㄋノノ
秬	禾匚ㄋ一一一
馧	禾日丨ㄋ一一
稌	禾余ノ丶丶丶
穜	禾立丨ㄋ一一
穄	禾祭ノㄋ丶丶
穙	禾业丶ノ丶丶
鹙	禾火ノㄋ一一
稑	禾土ノ丶一一
稙	禾直一丨一一
穟	禾㒸丶ㄋ丶丶
馝	禾日丶ㄋノノ
䅟	禾叁ノノノノ
遏	曷辶丶ㄋ丶丶
曷	曷丨ㄋㄋㄋ
歇	曷欠ノㄋ丶丶
鹖	曷鸟ノㄋ一一
黑	黑丨ㄋ丶丶
黝	黑幺ㄋノノノ
黪	黑叁ノノノノ
黥	黑京丶一丶丶
黔	黑今ノ丶ㄋㄋ
黯	黑音丶一一一
黩	黑十ㄋ丶丶丶
黠	黑吉一丨一一
黢	黑夋ㄋ丶丶丶
黟	黑夕ノㄋ丶丶
黜	黑出ㄋ丨丨丨
默	黑犬一ノ丶丶
墨	黑土一丨一一
乎	乎ノ丶丨丨
彪	虍几ノノノノ
遽	虍豕丶ㄋ丶丶
虞	虍口一一丶丶
虐	虍一ㄋ一一
虎	虍几ノㄋㄋㄋ
虏	虍力ㄋノノノ
虔	虍文丶一丶丶
虑	虍心丶ㄋ丶丶
虚	虍业丨丨一一
虍	虍丨一ㄋㄋ
觑	虍业丨ㄋㄋㄋ
虤	虍几丨一ㄋㄋ
甗	虍鬲一ㄋ丶丶
遍	户丶ㄋ丶丶
肩	户⺝丨ㄋ一一
扇	户羽ㄋ丶一一
扃	户冂丨ㄋ一一
扈	户口ㄋ丨ㄋㄋ
扁	户丨ㄋ丨丨
戽	户⺀一丨丨丨
房	户方丶一ノノ
启	户口丨ㄋ一一
戾	户犬一ノ丶丶
雇	户隹ノ丨一一
翩	户ㄋ丶一一
扉	户非丨一一一
綮	户攵ㄋㄋ丶丶
肇	户攵ㄋ一丨丨
扂	户占丨一一一
扅	户夕ノㄋ丶丶
扆	户衣丶一丶丶
扊	户炎丶ノ丶丶
回	回丨ㄋ一一
火	火丶ノ丶丶
熳	火日丨ㄋ一一
剡	炎刂丨丨丨丨
郯	炎卩ㄋ丨丨丨
炼	火练一ㄋ丶丶
炬	火匚ㄋ一一一
煅	火段ノ丨丶丶
煳	火古ノㄋ一一
炀	火汤ㄋノノノ
灼	火勹丶丶丶丶
炮	火勹ㄋ一ㄋㄋ
燧	火㒸丶ㄋ丶丶
煺	火艮丶ㄋ丶丶
焖	火门丶ㄋ丶丶
炯	火冂丨ㄋ一一
烟	火因丨ㄋ一一
煽	火户ㄋ丶一一
煸	火户丨ㄋ丨丨
炊	火欠ノㄋ丶丶
烤	火耂一ㄋㄋㄋ
烧	火尧一ㄋㄋㄋ
燃	火一ノ丶丶
熘	火留丨ㄋ一一
烨	火华ノㄋㄋㄋ
熠	火羽ノ丨一一
焓	火今丨ㄋ一一
熵	火商丶一一一
熔	火宀ノ丶一一
煊	火㝉丨ㄋ一一
烷	火宀一一ㄋㄋ
炕	火亠ノㄋㄋㄋ
炫	火玄丶一丶丶
烩	火人一一丶丶
燥	火口丨ㄋ丶丶
燠	火向丶ノ丶丶
燔	火番ノ丶一一
燎	火尞一ノ丶丶
烃	火轻ㄋ丶一一
焰	火ノ丨一一
焕	火丨ㄋ丶丶
烂	火兰丶ノ一一
煌	火白一一一一
焯	火卓丨一丨丨
烬	火尺丶丶丶丶
炷	火主丶一一一
煤	火甘一丨丶丶
炽	火口ノ丶丶丶
焙	火立丨ㄋ一一
爆	火日一丨丶丶
焊	火日一一丨丨
煜	火日丶一一一
煨	火田一一一一
烯	火希ノ丶丨丨
焐	火五丨ㄋ一一
炝	火仓ノ丶ㄋㄋ
炒	火小ノノノノ
炳	火丙ノ丶丶丶
爝	火爫丨ㄋ丶丶
烽	火夂一一丨丨
烙	火各ノㄋ一一
熄	火自丶ㄋ丶丶
烘	火共一丨丶丶
烛	火虫丨ㄋ丶丶
灯	火丁一丨丨丨
烀	火乎ノ丶丨丨
炉	火户丶ㄋノノ
炔	火夬ㄋ一丶丶
烁	火丨ノ丶丶
灿	火山丨ㄋ丨丨
炻	火石一ノ一一
灶	火土一丨一一
炖	火屯一ㄋㄋㄋ
炜	火韦一一丨丨
烊	火羊丶ノ丨丨
烦	火页一ノ丶丶
炸	火乍ノ一一一
焱	火火丶ノ丶丶
炎	炎丶ノ丶丶
烶	火壬ㄋ丶丶丶
焆	火口丨ㄋ一一
焜	火日一ㄋㄋㄋ
煓	火山一ノ丨丨
煴	火日丨ㄋ一一
熇	火高丶一一一
燏	火矛丨ㄋ一一
爚	火合丨ㄋ丨丨
丌	丌一ノ丨丨
及	及ノㄋ丶丶
暨	旡丨ㄋ一一
即	卩ㄋ丨丨丨
既	旡一ㄋㄋㄋ
飑	风勹ㄋ一ㄋㄋ
飓	风ノ丶丶丶
飕	风臼丨ㄋ丶丶
凰	几白一一一一
夙	几歹一ノ丶丶
凡	凡ノㄋ丶丶
凤	几又ㄋ丶丶丶
几	几ノㄋㄋㄋ
飚	风火丶ノ丶丶
剁	几木丨丨丨丨
风	风ノㄋ丶丶
朵	几木一丨丶丶
己	己ㄋ一ㄋㄋ
改	己攵ノ一丶丶
忌	己心丶ㄋ丶丶
彐	彐ㄋ一一一
寻	彐寸一丨丶丶
灵	彐火丶ノ丶丶
帚	彐冖丨ㄋ丨丨
蠡	彖虫丨ㄋ丶丶
彘	彑匕ノ一ㄋㄋ
彝	彑米ㄋㄋ丨丨
彖	彖ㄋㄋ丶丶
夹	夹人ノ丶丶丶
颊	夹人一ノ丶丶
郏	夹人ㄋ丨丨丨
甲	甲丨ㄋ丨丨
鸭	甲鸟ノㄋ一一
翈	甲羽ㄋ丶一一
遐	叚辶丶ㄋ丶丶
戋	戋一一丶丶
盏	戋皿丨ㄋ一一
鹣	兼鸟ノㄋ一一
歉	兼欠ノㄋ丶丶
兼	兼丶ノ丶丶
见	见丨ㄋㄋㄋ
辔	纟车ㄋㄋ一一
缍	纟垂ノ一一一
缋	纟贵丨ㄋ丶丶
缏	纟亻一丨丶丶
练	纟练一ㄋ丶丶
缎	纟段ノ丨丶丶
缴	纟白丶一丶丶
绑	纟ㄋ丨丨丨
纰	纟比一ㄋㄋㄋ
绗	纟彳一一丨丨
缑	纟亻ノ丨丶丶
缃	纟相一丨一一
缈	纟目丨ノ丶丶
纵	纟从ノ丶丶丶
绷	纟月ノㄋ一一
约	纟勹丶丶丶丶
绚	纟勹丨ㄋ一一
纫	纟刀丶丶丶丶
绒	纟戈一ノノノ
继	纟米ㄋㄋㄋㄋ
缝	纟夂一一丶丶
缱	纟中一丶丶丶
缒	纟ノ丨丶丶
缟	纟高丶一一一
绸	纟冂一丨一一
缄	纟咸一ノ丶丶
纲	纟冈丨ㄋ丶丶
缠	纟广丨ㄋ一一
编	纟户丨ㄋ丨丨
绪	纟者一丨一一
缮	纟羊丶ノ一一
绕	纟尧一ㄋㄋㄋ
缨	纟贝丨ㄋ一一
缵	纟先ノ一丶丶
缆	纟监丨ㄋㄋㄋ
缪	纟羽ノ丶ノノ
缀	纟双ㄋ丶丶丶
绺	纟夂丨丶丶丶
缛	纟辰一丨丶丶
缔	纟帝丨ㄋ丨丨
缡	纟㐫丨ㄋ丶丶
缩	纟宀ノ丨丨丨
缤	纟宀ノ丨一一
绽	纟定丶丶丶丶
综	纟宀一一丶丶
绾	纟宀丨ㄋ一一
统	纟ノㄋㄋㄋ
绞	纟交丶一丶丶
绘	纟人一一丶丶
缲	纟口丨ㄋ丶丶
给	纟合ノ丶一一
缰	纟一丨ㄋ一一
缭	纟尞一ノ丶丶
绶	纟受ㄋ丶丶丶
绿	纟录ㄋ一丶丶
缢	纟䒑ノ丶一一
经	纟轻ㄋ丶一一
纥	纟ㄋㄋㄋㄋ
绝	纟ㄋ丨ㄋㄋ
绉	纟刍ノㄋ一一
绡	纟肖丨丶一一
绱	纟尚丨丶一一
绻	纟ㄋㄋㄋㄋ
纷	纟分ノ丶ノノ
缯	纟曾丶ノ一一
绵	纟白丨ㄋ丨丨
纶	纟人ノㄋㄋㄋ
绰	纟卓丨一丨丨
缫	纟巛丨ㄋ一一
缁	纟巛丨ㄋ一一
绮	纟大一丨丨丨
绔	纟大一一ㄋㄋ
绍	纟召ㄋノ一一
纭	纟云一一丶丶
缚	纟甫一丨丶丶
绣	纟禾ㄋノノノ
缘	纟彖ㄋㄋ丶丶
织	纟口ノ丶丶丶
绢	纟口丨ㄋ一一
绳	纟口丨ㄋ一一
缉	纟口一丨一一
缕	纟米ㄋノ一一
缗	纟民丨ㄋ一一
缂	纟革一丨丨丨
绲	纟日一ㄋㄋㄋ
缇	纟是丨ㄋ丶丶
缜	纟直ノ丶丶丶
续	纟十ㄋ丶丶丶
结	纟吉一丨一一
缬	纟吉一ノ丶丶
绐	纟台ㄋ丶一一
缳	纟同ノㄋ丶丶
缧	纟田ㄋㄋ丶丶
缌	纟田丶ㄋ丶丶
绫	纟土ノ丶丶丶
缥	纟覀一一丶丶
纱	纟小ノノノノ
缙	纟亚丨ㄋ一一
绎	纟又一一丨丨
缦	纟日丨ㄋ丶丶
绥	纟爫ㄋノ一一
缓	纟爰ノ丶丶丶
终	纟夂丶丶丶丶
络	纟各ノㄋ一一
绛	纟夂ノㄋ丶丶
绦	纟夂一丨丶丶
绩	纟丨ㄋ丶丶
缣	纟兼丶ノ丶丶
绂	纟ㄋ丶丶丶
绊	纟半丶ノ丨丨
纽	纟丑ㄋ丨一一
绌	纟出ㄋ丨丨丨
纣	纟寸一丨丶丶
绨	纟弟丶ノノノ
纺	纟方丶一ノノ
绯	纟非丨一一一
绀	纟甘一丨一一
绠	纟更一丨丶丶
红	纟工一丨一一
纩	纟广丶一ノノ
级	纟及ノㄋ丶丶
纪	纟己ㄋ一ㄋㄋ
线	纟戋一一丶丶
纠	纟丩ㄋ丨丨丨
缅	纟丆丨ㄋ一一
纳	纟内丨ㄋ丶丶
纤	纟千ノ一丨丨
组	纟且丨ㄋ一一
绅	纟日丨丨丨丨
纸	纟氏ノㄋㄋㄋ
绁	纟世一丨ㄋㄋ
细	纟田丨ㄋ一一
纯	纟屯一ㄋㄋㄋ
纨	纟九丶丶丶丶
纬	纟韦一一丨丨
纹	纟文丶一丶丶
纡	纟于一一丨丨
纾	纟予ㄋ丶丨丨
维	纟隹ノ丨一一
绋	纟弓ノ丨丨丨
纻	纟㝉丶丶一一
纮	纟ㄋ丶丶丶
#缞	纟哀一ノ丶丶
绖	纟至一ㄋ一一
绹	纟勹ノ一丨丨
缊	纟日丨ㄋ一一
纴	纟壬ノ一一一
绤	纟谷ノ丶一一
缐	纟白丨ㄋ丶丶
䌹	纟冂丨ㄋ一一
邂	角刀ノ一丶丶
蟹	角刀ノ一丶丶
角	角ノㄋ丨丨
觥	角光丨丶ㄋㄋ
觞	角ㄋノノノ
觯	角单丶ノ丨丨
解	角刀ノ一丨丨
触	角虫丨ㄋ丶丶
斛	角⺀一丨丨丨
觚	角瓜ノノ丶丶
觖	角夬ㄋ一丶丶
觫	角束一丨丶丶
觿	角山ノ丨一一
觭	角大一丨丨丨
觟	角圭一丨一一
孢	孑勹ㄋ一ㄋㄋ
孩	孑亥丶一丶丶
孜	孑攵ノ一丶丶
孤	孑瓜ノノ丶丶
孙	孑小丨ノ丶丶
孔	孑乚ㄋㄋㄋㄋ
逊	孑小丶ㄋ丶丶
孑	孑ㄋ丨一一
孺	孑雨一ノ丨丨
巾	巾丨ㄋ丨丨
帙	巾丿一一丶丶
帧	巾⺊丨ㄋ丶丶
帆	巾凡ノㄋ丶丶
帼	巾囗一一丶丶
帱	巾一丨丶丶
幄	巾尸一ㄋ一一
帽	巾日丨ㄋ一一
幡	巾番ノ丶一一
帖	巾占丨一一一
帜	巾口ノ丶丶丶
幛	巾音一丨丨丨
幢	巾立丨ㄋ一一
幌	巾日丨丶ㄋㄋ
幞	巾业丶ノ丶丶
幅	巾同丨ㄋ一一
幔	巾日丨ㄋ丶丶
帻	巾丨ㄋ丶丶
帕	巾白ノ丨一一
帔	巾皮ㄋノ丶丶
帏	巾韦一一丨丨
帐	巾长ノ一丶丶
帷	巾隹ノ丨一一
近	斤辶丶ㄋ丶丶
斤	斤ノノ丨丨
斥	斤丶丶丶丶丶
欣	斤欠ノㄋ丶丶
颀	斤页一ノ丶丶
斶	斤罒ノㄋ丶丶
贪	今贝丨ㄋ丶丶
衾	今衣丶一丶丶
含	今口丨ㄋ一一
念	今心丶ㄋ丶丶
今	今ノ丶ㄋㄋ
颔	今口一ノ丶丶
铮	钅争ノㄋ丨丨
镙	钅田ㄋㄋ丶丶
镟	钅族丨一丶丶
钸	钅丨ㄋ丨丨
钶	钅丁丨ㄋ一一
钜	钅匚ㄋ一一一
钷	钅匚丨ㄋ一一
锻	钅段ノ丨丶丶
铑	钅耂ノㄋㄋㄋ
铆	钅卯ㄋ丨丨丨
铡	钅贝丨丨丨丨
镦	钅享ノ一丶丶
镞	钅族ノ一丶丶
镪	钅弓丨ㄋ一一
锹	钅禾丶ノ丶丶
锨	钅斤ノㄋ丶丶
铷	钅女丨ㄋ一一
铁	钅丿一一丶丶
铢	钅丿一一丶丶
锄	钅且ㄋノノノ
铴	钅氵ㄋノノノ
锵	钅丬ノㄋ丶丶
铘	钅牙ㄋ丨丨丨
锕	钅阝一丨丨丨
钓	钅勹丶丶丶丶
钧	钅勹丶一一一
钩	钅勹ㄋ丶丶丶
铽	钅弋丶ㄋ丶丶
铤	钅壬ㄋ丶丶丶
键	钅聿ㄋ丶丶丶
链	钅车丶ㄋ丶丶
镐	钅高丶一一一
钛	钅大丶丶丶丶
钒	钅凡ノㄋ丶丶
锎	钅门一一丨丨
镧	钅门一丨丶丶
锏	钅门丨ㄋ一一
铜	钅冂丨ㄋ一一
铖	钅戊ㄋㄋㄋㄋ
钢	钅冈丨ㄋ丶丶
锢	钅囗一丨一一
铟	钅因丨ㄋ一一
钗	钅又丶丶丶丶
镳	钅鹿丶丶丶丶
铸	钅一丨丶丶
镢	钅厂丶ノ丶丶
镛	钅广ㄋ一一一
镀	钅度ㄋ丶丶丶
镰	钅广丶ノ丶丶
镅	钅丨ㄋ一一
锔	钅尸ㄋ丨一一
锯	钅尸一丨一一
铌	钅尸ノㄋㄋㄋ
钣	钅ㄋ丶丶丶
钦	钅欠ノㄋ丶丶
铐	钅耂一ㄋㄋㄋ
锗	钅者一丨一一
铙	钅尧一ㄋㄋㄋ
铿	钅坚一丨一一
镏	钅留丨ㄋ一一
锴	钅比ノ丨一一
铧	钅华ノㄋㄋㄋ
锲	钅丰ㄋノノノ
锪	钅勿丶ㄋ丶丶
镩	钅宀ノ丶丶丶
镝	钅啇丶一一一
铲	钅产丶一ノノ
镑	钅帝丶一ノノ
镎	钅合ノ一丨丨
镥	钅鱼丨ㄋ一一
镗	钅一丨一一
钤	钅今ノ丶ㄋㄋ
铃	钅令ノ丶丶丶
镲	钅宀ノㄋ丶丶
镔	钅宀ノ丨一一
锭	钅定丶丶丶丶
铊	钅宀ノㄋㄋㄋ
铵	钅宀ㄋノ一一
镓	钅宀一ノ丶丶
铳	钅ノㄋㄋㄋ
镶	钅襄丶一丶丶
铱	钅衣丶一丶丶
#锿	钅哀ノㄋ丶丶
铰	钅交丶一丶丶
钪	钅亠ノㄋㄋㄋ
铈	钅亠丨ㄋ丨丨
铉	钅玄丶一丶丶
镜	钅音ノㄋㄋㄋ
镱	钅音丶ㄋ丶丶
铪	钅合ノ丶一一
镣	钅尞一ノ丶丶
镨	钅並丨ㄋ一一
镒	钅䒑ノ丶一一
锍	钅㐬丶一ㄋㄋ
铯	钅ㄋ丨ㄋㄋ
销	钅肖丨丶一一
锁	钅丨ㄋ丶丶
铛	钅ㄋ一一一
锖	钅青一一一一
铣	钅先ノ一ㄋㄋ
锆	钅告ノ一一一
镁	钅一ノ丶丶
锩	钅ㄋㄋㄋㄋ
锐	钅总ノㄋㄋㄋ
锦	钅白丨ㄋ丨丨
镫	钅登ㄋ丶一一
钻	钅占丨一一一
锘	钅艹一ノ一一
镆	钅莫一丨丶丶
镬	钅艹ノ丨丶丶
铹	钅劳ㄋノノノ
锚	钅艹丨ㄋ一一
锱	钅巛丨ㄋ一一
锛	钅大一丨丨丨
锒	钅良丶ㄋ丶丶
镊	钅耳ㄋ丶丶丶
镄	钅弓ノ丨丶丶
锈	钅禾ㄋノノノ
锬	钅炎丶ノ丶丶
锓	钅彐丶ㄋ丶丶
铅	钅几丨ㄋ一一
铞	钅口丨ㄋ丨丨
铝	钅口丨ㄋ一一
锅	钅呙丨ㄋ丶丶
锃	钅口一一一一
锫	钅立丨ㄋ一一
锌	钅辛丶一丨丨
镂	钅米ㄋノ一一
铥	钅丿一丨丶丶
锟	钅日一ㄋㄋㄋ
锡	钅日ノㄋㄋㄋ
钽	钅旦丨ㄋ一一
铠	钅山ㄋ一ㄋㄋ
镇	钅直ノ丶丶丶
钴	钅古一丨一一
镯	钅罒ノㄋ丶丶
锣	钅罒ノㄋ丶丶
锂	钅里丨ㄋ一一
锶	钅田丶ㄋ丶丶
铨	钅人一一一一
铩	钅乂一丨丶丶
铭	钅夕丨ㄋ一一
镡	钅覀丨ㄋ丨丨
镖	钅覀一一丶丶
钞	钅小ノノノノ
锷	钅吅一一ㄋㄋ
镤	钅业丶ノ丶丶
钲	钅正一丨一一
锼	钅臼丨丨丨丨
铎	钅又一一丨丨
镭	钅雨丨ㄋ一一
镘	钅日丨ㄋ丶丶
锝	钅日一一丶丶
铕	钅丨ㄋ一一
锊	钅爫一丨丶丶
锾	钅爰ノ丶丶丶
锋	钅夂一一丨丨
铬	钅各ノㄋ一一
镌	钅隹ㄋノノノ
锰	钅子丨ㄋ一一
镍	钅自一丨丶丶
错	钅昔一丨一一
钯	钅巴ㄋ丨ㄋㄋ
钹	钅ㄋ丶丶丶
铂	钅白ノ丨一一
钵	钅木一一一一
铋	钅必丶ㄋ丶丶
钋	钅卜丨丶丶丶
钚	钅不一ノ丶丶
钊	钅刂丨丨丨丨
锸	钅千ノ丨一一
钮	钅丑ㄋ丨一一
钏	钅川ノ丨丨丨
锤	钅垂ノ一一一
锑	钅弟丶ノノノ
钉	钅丁一丨丨丨
钭	钅⺀一丨丨丨
铒	钅耳一丨一一
钫	钅方丶一ノノ
铺	钅甫一丨丶丶
钙	钅一丨一ㄋㄋ
钳	钅甘一丨一一
镉	钅鬲一丨丨丨
银	钅艮ㄋ一丶丶
锞	钅日一丨丶丶
钬	钅火丶ノ丶丶
铗	钅夹ノ丶丶丶
钾	钅甲丨ㄋ丨丨
钱	钅戋一一丶丶
铼	钅夹丨ノ丶丶
铄	钅丨ノ丶丶
钌	钅了ㄋ丨丨丨
钔	钅门丶丨ㄋㄋ
钼	钅目丨ㄋ一一
钠	钅内丨ㄋ丶丶
钕	钅女ㄋノ一一
铍	钅皮ㄋノ丶丶
钎	钅千ノ一丨丨
钐	钅彡ノノノノ
针	钅十一丨丨丨
钿	钅田丨ㄋ一一
钍	钅土一丨一一
钝	钅屯一ㄋㄋㄋ
锇	钅我ノ一丶丶
钨	钅乌ㄋㄋㄋㄋ
钇	钅乙ㄋㄋㄋㄋ
钆	钅乚ㄋㄋㄋㄋ
铀	钅由丨ㄋ一一
钰	钅王丶丶丶丶
钥	钅月ノㄋ一一
钺	钅戉一ㄋ丶丶
铫	钅儿丶一丶丶
钟	钅中丨ㄋ丨丨
锺	钅千丨ㄋ一一
锥	钅隹ノ丨一一
锉	钅从一丨一一
镕	钅宀ノ丶一一
锜	钅大一丨丨丨
镠	钅羽ノ丶ノノ
铚	钅至一ㄋ一一
铏	钅开丨丨丨丨
钘	钅开一一丨丨
镴	钅巛丨ㄋㄋㄋ
镈	钅甫一丨丶丶
镚	钅山ノㄋ一一
锽	钅白一一一一
镮	钅同ノㄋ丶丶
铻	钅五丨ㄋ一一
锳	钅艹丨ㄋ丶丶
钖	钅汤ㄋノノノ
镃	钅䒑ㄋㄋ丶丶
锧	钅一丨丶丶
䥽	钅发ㄋノ丶丶
金	金ノ丶一一
鑫	金金ノ丶一一
进	井辶丶ㄋ丶丶
收	丩攵ノ一丶丶
馗	九䒑ノ丨一一
旭	九日丨ㄋ一一
九	九ノㄋㄋㄋ
丸	九丶丶丶丶丶
鸠	九鸟ノㄋ一一
杂	九朩一丨丶丶
旮	九日丨ㄋ一一
訄	九言丶一一一
虓	九虍ノㄋㄋㄋ
叟	臼丨ㄋ丶丶丶
臼	臼ノ丨一一
臾	臼人ノ丶丶丶
鼢	鼠分ノ丶ノノ
鼹	鼠日丶丶一一
鼯	鼠五丨ㄋ一一
鼷	鼠爫ㄋㄋ丶丶
鼬	鼠由丨ㄋ一一
毁	臼工ノㄋ丶丶
鼠	鼠ノ丨ㄋㄋ
舄	臼勹丶丶丶丶
舅	臼田ㄋノノノ
舁	臼廾一ノ丨丨
鼩	鼠句ノㄋ一一
鼱	鼠青一一一一
鼫	鼠石一ノ一一
具	八ノ丶丶丶
歌	可可ノㄋ丶丶
可	可一丨丨丨
哥	可可一丨丨丨
逞	口王丶ㄋ丶丶
盅	中皿丨ㄋ一一
忠	中心丶ㄋ丶丶
中	中丨ㄋ丨丨
口	口丨ㄋ一一
史	口乂ノ丶丶丶
串	口中丨ㄋ丨丨
郢	口王ㄋ丨丨丨
咭	口吉一丨一一
哜	口文ノ丨丨丨
鹃	口⺝ノㄋ一一
勋	口贝ㄋノノノ
郧	口贝ㄋ丨丨丨
嗣	口ㄋ丨一一
戢	口耳一ㄋ丶丶
别	另刂丨丨丨丨
剐	呙刂丨丨丨丨
鄙	口十丨ㄋ丨丨
咂	口匚丨ㄋ丨丨
哐	口匚一一一一
呕	口区一ノㄋㄋ
唧	口ㄋ丨丨丨
啷	口朗ㄋ丨丨丨
唰	口尸丨ㄋ丨丨
嘟	口者ㄋ丨丨丨
嘶	口其ノノ丨丨
嗷	口敖一一丶丶
嘞	口革ㄋノノノ
噼	口辟ㄋ一丨丨
嘲	口ノㄋ一一
嘭	口壴ノノノノ
吡	口比一ㄋㄋㄋ
哪	口ㄋ丨丨丨
啭	口车一一丶丶
咧	口歹丨丨丨丨
喉	口亻ノ丨丶丶
咐	口付ノ丨丶丶
咻	口亻一丨丶丶
咿	口亻ㄋ一ノノ
嗾	口族ノ一丶丶
吲	口弓丨丨丨丨
啾	口禾丶ノ丶丶
哟	口纟ノㄋㄋㄋ
咖	口加ㄋノ一一
啉	口林一丨丶丶
嗍	口屰ノㄋ一一
呶	口女ㄋ丶丶丶
嗨	口氵ノ一丶丶
啵	口氵ㄋノ丶丶
嗽	口束ノㄋ丶丶
喇	口束丨丨丨丨
啪	口扌ノ丨一一
哳	口折一丨丨丨
啦	口扌丶一一一
呦	口幺ㄋノノノ
呲	口此丨一ㄋㄋ
吼	口孑ㄋㄋㄋㄋ
啊	口阝一丨丨丨
呵	口可一丨丨丨
鸣	口鸟ノㄋ一一
吻	口勿ノㄋノノ
啕	口勹ノ一丨丨
咆	口勹ㄋ一ㄋㄋ
嗵	口甬丶ㄋ丶丶
哒	口大丶ㄋ丶丶
响	口向丨ㄋ一一
呗	口贝丨ㄋ丶丶
呔	口大丶丶丶丶
啁	口冂一丨一一
嘁	口戊丨一丶丶
喊	口咸一ノ丶丶
咽	口因丨ㄋ一一
唬	口虍ノㄋㄋㄋ
噱	口虍一ノ丶丶
嘘	口虍丨丨一一
嗟	口一丨一一
噘	口厂丶ノ丶丶
喱	口厂丨ㄋ一一
呖	口厂ㄋノノノ
呃	口厂ㄋㄋㄋㄋ
嘛	口麻丶一丶丶
唳	口户一ノ丶丶
咴	口丶ノ丶丶
喔	口尸一ㄋ一一
呢	口尸ノㄋㄋㄋ
嘱	口尸ノ丨丶丶
啤	口卑ノ丨丨丨
嘈	口曹一丨一一
吹	口欠ノㄋ丶丶
嗜	口耂ノㄋ一一
哮	口耂ㄋ丨一一
囔	口橐丨ㄋ丶丶
哓	口尧一ㄋㄋㄋ
咝	口ㄋㄋ一一
嘤	口贝丨ㄋ一一
喈	口比ノ丨一一
哔	口比一丨丨丨
哗	口华ノㄋㄋㄋ
噤	口林一一丶丶
啜	口双ㄋ丶丶丶
嘴	口此ノㄋ丨丨
唿	口勿丶ㄋ丶丶
嗯	口因丶ㄋ丶丶
噙	口人丶一丶丶
啼	口帝丨ㄋ丨丨
噻	口寒一丨一一
嘧	口宀丶ㄋ丨丨
嘀	口啇丶一一一
哼	口亨丶一丨丨
嚎	口亮一ノ丶丶
噜	口鱼丨ㄋ一一
咣	口光丨丶ㄋㄋ
嗡	口公ㄋ丶一一
吟	口今ノ丶ㄋㄋ
呤	口令ノ丶丶丶
嚓	口宀ノㄋ丶丶
喧	口㝉丨ㄋ一一
喀	口宀ノㄋ丶丶
啶	口定丶丶丶丶
咛	口宀一丨丨丨
咤	口宀ノ一ㄋㄋ
咳	口亥丶一丶丶
嚷	口襄丶一丶丶
咬	口交丶一丶丶
吭	口亠ノㄋㄋㄋ
唷	口丨ㄋ一一
哙	口人一一丶丶
噪	口口丨ㄋ丶丶
噫	口音丶ㄋ丶丶
噢	口向丶ノ丶丶
喷	口十一丨丶丶
嗦	口孛ㄋㄋ丶丶
嚏	口孛丨ㄋ丶丶
嘻	口壴丨ㄋ一一
嗑	口去丨ㄋ一一
喻	口俞ノ丶丨丨
啥	口舍ノ丶一一
哈	口合ノ丶一一
嗓	口又ㄋ丶丶丶
嘹	口尞一ノ丶丶
嗳	口受一ノ丶丶
嗌	口䒑ノ丶一一
吃	口ㄋㄋㄋㄋ
唤	口丨ㄋ丶丶
哨	口肖丨丶一一
唢	口丨ㄋ丶丶
唪	口一一丨丨
嗪	口ノ一丶丶
噬	口一丨丶丶
吩	口分ノ丶ノノ
噌	口曾丶ノ一一
嗥	口白一ノ丨丨
唣	口白一ㄋㄋㄋ
噔	口登ㄋ丶一一
呸	口不一一一一
嗬	口荷一丨丨丨
嚆	口艹丶一一一
喏	口艹一ノ一一
嗒	口艹ノ丶一一
噶	口艹丨ㄋㄋㄋ
唠	口劳ㄋノノノ
喵	口艹丨ㄋ一一
呓	口艹ㄋㄋㄋㄋ
哎	口艹ノ丶丶丶
嗤	口蚩ㄋ丨丶丶
喹	口大一丨一一
嗫	口耳ㄋ丶丶丶
嗲	口父ノㄋ丶丶
嘎	口丆丨ㄋ丶丶
啖	口炎丶ノ丶丶
哚	口几一丨丶丶
喙	口彖ㄋㄋ丶丶
唼	口立ㄋノ一一
喑	口音丶一一一
喽	口米ㄋノ一一
喳	口木丨ㄋ一一
嘬	口日一丨丶丶
唱	口日丨ㄋ一一
嘣	口山ノㄋ一一
喘	口山一ノ丨丨
哕	口山ノㄋ丶丶
咔	口上丨丶丶丶
喃	口十丨ㄋ丨丨
嗔	口直ノ丶丶丶
啐	口卒丶一丨丨
咕	口古一丨一一
吱	口十ㄋ丶丶丶
噎	口壳一丨一一
喋	口世一丨丶丶
唆	口夋ㄋ丶丶丶
吮	口厶ノㄋㄋㄋ
哞	口厶ノ一丨丨
唉	口厶ノ一丶丶
喟	口田丨ㄋ一一
哩	口里丨ㄋ一一
喂	口田一ㄋ丶丶
哧	口赤一丨丶丶
哇	口圭一丨一一
唏	口希ノ丶丨丨
唔	口五丨ㄋ一一
哆	口夕ノㄋ丶丶
嘌	口覀一一丶丶
呛	口仓ノ丶ㄋㄋ
吵	口小ノノノノ
噗	口业丶ノ丶丶
嗖	口臼丨ㄋ丶丶
嚅	口雨一ノ丨丨
嚯	口雨ノ丨一一
喝	口曷丨ㄋㄋㄋ
嚼	口爫丨ㄋ丶丶
嗄	口丆丨ㄋ丶丶
咚	口夂丶丶丶丶
咯	口各ノㄋ一一
啃	口止丨ㄋ一一
啮	口齿丨一丨丨
噍	口隹丶丶丶丶
嗅	口自一ノ丶丶
啧	口丨ㄋ丶丶
嗉	口ㄋㄋ丶丶
唛	口ノㄋ丶丶
哄	口共一丨丶丶
叱	口七ノㄋㄋㄋ
哌	口ノㄋ丶丶
叭	口八ノ丶丶丶
吧	口巴ㄋ丨ㄋㄋ
卟	口卜丨丶丶丶
咄	口出ㄋ丨丨丨
啄	口豕丶丶丶丶
唾	口垂ノ一一一
叩	口卩ㄋ丨丨丨
叨	口刀ㄋノノノ
叼	口一一一一
叮	口丁一丨丨丨
啡	口非丨一一一
呋	口夫一一丶丶
哺	口甫一丨丶丶
嗝	口鬲一丨丨丨
哏	口艮ㄋ一丶丶
哽	口更一丨丶丶
呱	口瓜ノノ丶丶
嘿	口黑丨ㄋ丶丶
呼	口乎ノ丶丨丨
吸	口及ノㄋ丶丶
叽	口几ノㄋㄋㄋ
呷	口甲丨ㄋ丨丨
听	口斤ノノ丨丨
叫	口丩ㄋ丨丨丨
叻	口力ㄋノノノ
咙	口龙一ノ丶丶
吗	口马ㄋㄋ一一
咪	口米丶ノ丶丶
呐	口内丨ㄋ丶丶
哝	口农丶ㄋノノ
咀	口且丨ㄋ一一
吠	口犬一ノ丶丶
呻	口日丨丨丨丨
叶	口十一丨丨丨
啸	口肀ノ丶丨丨
吐	口土一丨一一
吨	口屯一ㄋㄋㄋ
吒	口乇ノ一ㄋㄋ
味	口未一一丶丶
哦	口我ノ一丶丶
呜	口乌ㄋ一一一
呒	口一一ノㄋㄋ
哂	口西一丨一一
吓	口下一丨丶丶
吣	口心丶ㄋ丶丶
吖	口丷丨丨丨丨
呀	口牙一ㄋノノ
哑	口亚一丨一一
唁	口言丶一一一
咩	口羊丶ノ丨丨
吆	口幺ㄋㄋ丶丶
咦	口大ㄋ一ㄋㄋ
咏	口永丶ㄋ丶丶
叹	口又ㄋ丶丶丶
吁	口于一一丨丨
喁	口禺丨ㄋ丶丶
咋	口乍ノ一一一
唯	口隹ノ丨一一
咱	口自ノ丨一一
唑	口从一丨一一
饕	口丂丨一丶丶
患	口中丶ㄋ丶丶
只	口八ノ丶丶丶
员	口贝丨ㄋ丶丶
吴	口天一一丶丶
邑	口巴ㄋ丨ㄋㄋ
虽	口虫丨ㄋ丶丶
黾	口日ㄋㄋㄋㄋ
兄	口儿ノㄋㄋㄋ
吊	口巾丨ㄋ丨丨
号	口丂一ㄋㄋㄋ
吕	口口丨ㄋ一一
另	另丨ㄋノノ
呆	口木一丨丶丶
呙	呙丨ㄋ丶丶
呈	口王一一一一
品	口吅丨ㄋ一一
鸮	口丂ノㄋ一一
咇	口心ノノノノ
咥	口至一ㄋ一一
啫	口者一丨一一
喤	口白一一一一
嗞	口䒑ㄋㄋ丶丶
嘡	口一丨一一
噇	口立丨ㄋ一一
嚄	口艹ノ丨丶丶
亏	亏一一ㄋㄋ
来	夹来丨ノ丶丶
赉	夹来丨ㄋ丶丶
慭	夹来一ノ丶丶
莺	劳鸟ノㄋ一一
萦	劳糸ㄋㄋ丶丶
荤	劳车一ㄋ丨丨
萤	劳虫丨ㄋ丶丶
荧	劳火丶ノ丶丶
蓥	劳金ノ丶一一
劳	劳力ㄋノノノ
荦	劳牛ノ一丨丨
荥	劳水丨ㄋ丶丶
茔	劳土一丨一一
莹	劳王丶丶丶丶
茕	劳一丨丨丨
耋	耂匕一ㄋ一一
耄	耂匕ノ一ㄋㄋ
者	者一丨一一
耆	耂旨ノㄋ一一
孝	耂子ㄋ丨一一
翥	者者一丨一一
煮	者灬丶丶丶丶
老	耂匕ノㄋㄋㄋ
都	者阝ㄋ丨丨丨
教	耂子ノ一丶丶
考	耂丂一ㄋㄋㄋ
耇	耂句ノㄋ一一
辽	了辶丶ㄋ丶丶
函	了ㄋ丨丨丨
卺	丞㔾ㄋㄋㄋㄋ
丞	丞ㄋ丨一一
了	了ㄋ丨丨丨
承	了三ㄋノ丶丶
亟	了口ㄋ丶一一
孓	了丶丶丶丶丶
耒	耒一一丶丶
耱	耒麻一ノ一一
耨	耒辰一丨丶丶
耪	耒帝丶一ノノ
耠	耒合ノ丶一一
耥	耒尚丨丶一一
耢	耒劳ㄋノノノ
耘	耒云一一丶丶
耧	耒米ㄋノ一一
耩	耒冓一一一一
耖	耒小ノノノノ
耙	耒巴ㄋ丨ㄋㄋ
耕	耒井一一丨丨
耗	耒毛ノ一ㄋㄋ
耜	耒㠯丨ㄋ一一
耦	耒禺丨ㄋ丶丶
耔	耒子ㄋ丨一一
耤	耒昔一丨一一
里	里丨ㄋ一一
野	里予ㄋ丶丨丨
墅	里予一丨一一
迦	加辶丶ㄋ丶丶
边	力辶丶ㄋ丶丶
贺	加贝丨ㄋ丶丶
袈	加衣丶一丶丶
驾	加马ㄋㄋ一一
架	加木一丨丶丶
力	力ㄋノノノ
办	力八ノ丶丶丶
勰	力力ㄋノ丶丶
加	加ㄋノ一一
哿	加可一丨丨丨
产	产丶一ノノ
立	立丶一一一
赣	音十ノㄋ丶丶
彰	音十ノノノノ
鄣	音十ㄋ丨丨丨
毅	立豕ノㄋ丶丶
剖	立口丨丨丨丨
瓿	立口一ㄋ丶丶
部	立口ㄋ丨丨丨
新	立朩ノノ丨丨
瓣	辛瓜丶一丨丨
辣	束一丨丶丶
辨	辛丶一丨丨
辫	辛纟丶一丨丨
辩	辛讠丶一丨丨
翊	立羽ㄋ丶一一
飒	立风ノㄋ丶丶
靖	立青一一一一
站	立占丨一一一
端	立山一ノ丨丨
竣	立夋ㄋ丶丶丶
竭	立曷丨ㄋㄋㄋ
竦	立束一丨丶丶
戆	音十ノㄋ丶丶
竞	立口ノㄋㄋㄋ
章	音十一丨丨丨
童	立里丨ㄋ一一
妾	立女ㄋノ一一
亲	立朩一丨丶丶
竑	立ㄋ丶丶丶
竘	立句ノㄋ一一
净	冫争ノㄋ丨丨
资	次贝丨ㄋ丶丶
咨	次口丨ㄋ一一
粢	次米丶ノ丶丶
盗	次皿丨ㄋ一一
姿	次女ㄋノ一一
瓷	次瓦一ㄋ丶丶
恣	次心丶ㄋ丶丶
凝	冫疑ノㄋ丶丶
冽	冫歹丨丨丨丨
凇	冫木ノ丶丶丶
凋	冫冂一丨一一
减	冫咸一ノ丶丶
次	次丶一丶丶
凄	冫妻ㄋノ一一
凛	冫亠丨ㄋ丶丶
凉	冫京丶一丶丶
冷	冫令ノ丶丶丶
冼	冫先ノ一ㄋㄋ
凑	冫一一丶丶
况	冫口ノㄋㄋㄋ
冶	冫台ㄋ丶一一
凌	冫土ノ丶丶丶
冻	冫东一ㄋ丶丶
冱	冫一ㄋㄋ一一
决	冫夬ㄋ一丶丶
冯	冫马ㄋㄋ一一
冰	冫水丨ㄋ丶丶
冲	冫中丨ㄋ丨丨
准	冫隹ノ丨一一
鹩	尞鸟ノㄋ一一
梵	林凡ノㄋ丶丶
麓	林鹿丶一ㄋㄋ
棼	林分ノ丶ノノ
楚	林疋ㄋ丨丶丶
焚	林火丶ノ丶丶
婪	林女ㄋノ一一
禁	林示一一丶丶
梦	林夕ノㄋ丶丶
彬	林彡ノノノノ
郴	林阝ㄋ丨丨丨
林	林一丨丶丶
令	令ノ丶丶丶
翎	令羽ㄋ丶一一
瓴	令瓦一ㄋ丶丶
领	令页一ノ丶丶
邻	令阝ㄋ丨丨丨
鸰	令鸟ノㄋ一一
兖	六厶ノㄋㄋㄋ
六	六丶一丶丶
衮	六厶ノㄋ丶丶
交	交丶一丶丶
效	交攵ノ一丶丶
郊	交阝ㄋ丨丨丨
袭	龙衣丶一丶丶
龚	龙共一丨丶丶
聋	龙耳一丨一一
砻	龙石一ノ一一
垄	龙土一丨一一
詟	龙言丶一一一
䶮	龙天一一丶丶
麝	鹿身一丨丶丶
麈	鹿主丶一一一
麇	鹿禾ノ一丶丶
麂	鹿几ノㄋㄋㄋ
鏖	鹿金ノ丶一一
麋	鹿米丶ノ丶丶
鹿	鹿丶一ㄋㄋ
麒	鹿其一丨丶丶
麟	鹿米ノㄋ丨丨
麑	鹿臼ノㄋㄋㄋ
鄜	鹿阝ㄋ丨丨丨
麀	鹿匕ノㄋㄋㄋ
麖	鹿京丶一丶丶
马	马ㄋㄋ一一
驱	马区一ノㄋㄋ
驸	马付ノ丨丶丶
驹	马句ノㄋ一一
骟	马户ㄋ丶一一
骗	马户丨ㄋ丨丨
骣	马尸ㄋ丨一一
骖	马叁ノノノノ
骐	马其一丨丶丶
骁	马尧一ㄋㄋㄋ
骝	马留丨ㄋ一一
骥	马北丨ㄋ丶丶
骅	马华ノㄋㄋㄋ
骤	马耳ㄋ丶丶丶
骢	马囟ノㄋ丶丶
骚	马又丶丨丶丶
驼	马宀ノㄋㄋㄋ
骇	马亥丶一丶丶
骧	马襄丶一丶丶
骄	马夭ノ丨丨丨
验	马佥ノ丶一一
驺	马刍ノㄋ一一
骈	马䒑一ノ丨丨
骑	马大一丨丨丨
驻	马主丶一一一
骏	马夋ㄋ丶丶丶
骀	马台ㄋ丶一一
骡	马田ㄋㄋ丶丶
骠	马覀一一丶丶
骊	马丽一丨丶丶
驳	马爻ノ丶丶丶
骋	马由一ㄋㄋㄋ
驿	马又一一丨丨
骆	马各ノㄋ一一
驯	马川ノ丨丨丨
驮	马大一ノ丶丶
骒	马日一丨丶丶
驴	马户丶ㄋノノ
驵	马且丨ㄋ一一
驶	马口ノ丶丶丶
驷	马四丨ㄋ一一
驰	马也ㄋ丨ㄋㄋ
驭	马又ㄋ丶丶丶
骓	马隹ノ丨一一
骎	马彐丶ㄋ丶丶
骙	马癸ㄋ丶丶丶
骃	马因丨ㄋ一一
骕	马肀ノ丶丨丨
骍	马辛丶一丨丨
驲	马日丨ㄋ一一
毽	毛聿ㄋ丶丶丶
氇	毛鱼丨ㄋ一一
毡	毛占丨一一一
毯	毛炎丶ノ丶丶
毪	毛厶ノ一丨丨
毛	毛ノ一ㄋㄋ
氆	毛並丨ㄋ一一
毳	毛毛ノ一ㄋㄋ
阚	门敢ノ一丶丶
阀	门亻一ㄋ丶丶
阏	门方ノ丶丶丶
阙	门屰ノㄋ丶丶
阈	门戈丨ㄋ一一
闼	门大丶ㄋ丶丶
阃	门囗一丨丶丶
闳	门ㄋ丶丶丶
阂	门亥丶一丶丶
闶	门亠ノㄋㄋㄋ
闹	门亠丨ㄋ丨丨
阖	门去丨ㄋ一一
阌	门受ㄋ丶丶丶
阎	门ノ丨一一
阐	门单丶ノ丨丨
阅	门总ノㄋㄋㄋ
阉	门大丨ㄋㄋㄋ
门	门丶丨ㄋㄋ
鹇	门木ノㄋ一一
阔	门氵ノ一一一
阕	门癸ㄋ丶丶丶
阆	门良丶ㄋ丶丶
阋	门臼ノㄋㄋㄋ
闾	门口丨ㄋ一一
阒	门目一ノ丶丶
阊	门日丨ㄋ一一
阗	门直ノ丶丶丶
阍	门氏丨ㄋ一一
闺	门圭一丨一一
阁	门各ノㄋ一一
闭	门才一丨ノノ
闽	门虫丨ㄋ丶丶
闻	门耳一丨一一
阄	门丨ㄋㄋㄋ
闸	门甲丨ㄋ丨丨
阑	门柬一丨丶丶
问	门口丨ㄋ一一
闯	门马ㄋㄋ一一
闲	门木一丨丶丶
闪	门人ノ丶丶丶
间	门日丨ㄋ一一
闫	门三一一一一
闰	门王一一一一
闱	门韦一一丨丨
闵	门文丶一丶丶
闷	门心丶ㄋ丶丶
闩	门一一一一一
闿	门山ㄋ一ㄋㄋ
阇	门者一丨一一
阘	门日ㄋ丶一一
訚	门言丶一一一
遴	米舛丶ㄋ丶丶
迷	米辶丶ㄋ丶丶
米	米丶ノ丶丶
断	米乚ノノ丨丨
粼	米舛ㄋㄋㄋㄋ
数	米女ノ一丶丶
糊	米古ノㄋ一一
糇	米亻ノ丨丶丶
糨	米弓丨ㄋ丶丶
糙	米告丶ㄋ丶丶
粝	米厂一ㄋノノ
糖	米广ㄋ一一一
糠	米广ㄋ一丶丶
糁	米叁ノノノノ
糟	米曹一丨一一
糌	米夂丨丶一一
粽	米宀一一丶丶
糈	米疋丨ㄋ一一
精	米青一一一一
粉	米分ノ丶ノノ
粘	米占丨一一一
粮	米良丶ㄋ丶丶
糅	米矛一丨丶丶
粹	米卒丶一丨丨
糕	米羊丶丶丶丶
糯	米雨一ノ丨丨
糗	米自一ノ丶丶
糍	米䒑ㄋㄋ丶丶
粑	米巴ㄋ丨ㄋㄋ
粕	米白ノ丨一一
料	米⺀一丨丨丨
敉	米攵ノ一丶丶
粳	米更一丨丶丶
粒	米立丶一一一
粗	米且丨ㄋ一一
籼	米山丨ㄋ丨丨
粞	米西一丨一一
籽	米子ㄋ丨一一
粪	米共一丨丶丶
类	米大一ノ丶丶
娄	米女ㄋノ一一
粿	米日一丨丶丶
糸	糸ㄋㄋ丶丶
勉	免力ㄋノノノ
逸	免丶丶ㄋ丶丶
免	免ノㄋㄋㄋ
兔	免丶丶丶丶丶
皿	皿丨ㄋ一一
慕	莫丨丶丶丶
幕	莫巾丨ㄋ丨丨
募	莫力ㄋノノノ
蓦	莫马ㄋㄋ一一
暮	莫日丨ㄋ一一
摹	莫手ノ一丨丨
墓	莫土一丨一一
莫	莫一丨丶丶
鄚	莫阝ㄋ丨丨丨
母	母ㄋㄋ丶丶
槿	木堇一丨一一
楝	木柬一丨丶丶
橼	木纟ㄋㄋ丶丶
栎	木丨ノ丶丶
棣	木隶ㄋ一丶丶
栊	木龙一ノ丶丶
杩	木马ㄋㄋ一一
榷	木冖ノ丨一一
术	木丶丶丶丶丶
述	木丶丶ㄋ丶丶
樊	木爻一丨丶丶
皙	木斤ノ丨一一
懋	木矛一丨丶丶
想	相心丶ㄋ丶丶
攀	木爻一丨丨丨
本	木一一一一一
木	木一丨丶丶
柬	柬一丨丶丶
榀	木口丨ㄋ一一
楱	木一一丶丶
麴	十人ノ丶ㄋㄋ
刺	朿刂丨丨丨丨
棘	朿朿一丨丶丶
柜	木匚ㄋ一一一
榧	木匚丨一一一
柩	木匚ノㄋ丶丶
框	木匚一一一一
椴	木段ノ丨丶丶
概	木一ㄋㄋㄋ
榔	木朗ㄋ丨丨丨
栳	木耂ノㄋㄋㄋ
柳	木卯ㄋ丨丨丨
檄	木白丶一丶丶
椒	木上丨ノ丶丶
橄	木敢ノ一丶丶
梆	木ㄋ丨丨丨
枇	木比一ㄋㄋㄋ
桁	木彳一一丨丨
椰	木耳ㄋ丨丨丨
楸	木禾丶ノ丶丶
槲	木角丶丶丨丨
枷	木加ㄋノ一一
株	木丿一一丶丶
枞	木从ノ丶丶丶
桫	木氵丨ノノノ
榭	木身一丨丶丶
栩	木羽ㄋ丶一一
棚	木月ノㄋ一一
椭	木阝一ノ一一
杨	木汤ㄋノノノ
柯	木可一丨丨丨
杓	木勹丶丶丶丶
枸	木句ノㄋ一一
构	木勹ㄋ丶丶丶
械	木戈一ノ丨丨
樾	木走一ㄋ丶丶
梃	木壬ㄋ丶丶丶
楗	木聿ㄋ丶丶丶
槌	木丶ㄋ丶丶
槁	木高丶一一一
枧	木见丨ㄋㄋㄋ
榈	木门丨ㄋ一一
桐	木冂丨ㄋ一一
槭	木戊丨一丶丶
枫	木风ノㄋ丶丶
杈	木又丶丶丶丶
檐	木厃ノ丶一一
桅	木厃ㄋㄋㄋㄋ
槎	木一丨一一
橱	木厂一丨丶丶
橛	木厂丶ノ丶丶
枥	木厂ㄋノノノ
桩	木广一丨一一
楣	木丨ㄋ一一
樨	木尸丨丶丨丨
榍	木尸丨丶一一
椐	木尸一丨一一
栀	木一ㄋㄋㄋ
板	木ㄋ丶丶丶
槽	木曹一丨一一
栲	木耂一ㄋㄋㄋ
楮	木者一丨一一
棋	木其一丨丶丶
樯	木十丶ノ一一
桡	木尧一ㄋㄋㄋ
桎	木至一ㄋ一一
樱	木贝丨ㄋ一一
榄	木监丨ㄋㄋㄋ
槛	木监丨ㄋ一一
榴	木留丨ㄋ一一
楷	木比ノ丨一一
楔	木丰ㄋノ丶丶
椹	木其ㄋㄋㄋㄋ
檎	木人丶一丶丶
榉	木兴ノ丶丨丨
榨	木穴ノ一一一
檀	木亠丨ㄋ一一
檩	木亠丨ㄋ丶丶
榜	木帝丶一ノノ
椋	木京丶一丶丶
椁	木享丶一一一
橹	木鱼丨ㄋ一一
樘	木一丨一一
桄	木光丨丶ㄋㄋ
樽	木酋一丨丶丶
柃	木令ノ丶丶丶
榕	木宀ノ丶一一
檫	木宀ノㄋ丶丶
槟	木宀ノ丨丶丶
楦	木㝉丨ㄋ一一
柁	木宀ノㄋㄋㄋ
柠	木宀一丨丨丨
桉	木宀ㄋノ一一
棕	木宀一一丶丶
棺	木宀丨ㄋ一一
核	木亥丶一丶丶
#榱	木哀一ノ丶丶
校	木交丶一丶丶
杭	木亠ノㄋㄋㄋ
柿	木亠丨ㄋ丨丨
桧	木人一一丶丶
桥	木夭ノ丨丨丨
榆	木俞ノ丶丨丨
检	木佥ノ丶一一
梳	木㐬丶一ㄋㄋ
梅	木每ノ一丶丶
杵	木一丨丨丨
橡	木象ノㄋ丶丶
梢	木肖丨丶一一
档	木ㄋ一一一
梏	木告ノ一一一
棒	木一一丨丨
榛	木ノ一丶丶
椿	木丨ㄋ一一
松	木公ノ丶丶丶
栏	木兰丶ノ一一
槔	木白一ノ丨丨
棉	木白丨ㄋ丨丨
橙	木登ㄋ丶一一
桢	木⺊丨ㄋ丶丶
棹	木卓丨一丨丨
栌	木⺊ㄋ一ノノ
栉	木艹ㄋ丨丨丨
檬	木劳一一丶丶
模	木莫一丨丶丶
椅	木大一丨丨丨
柱	木主丶一一一
楹	木乃ㄋ丶一一
棂	木彐丶ノ丶丶
椽	木彖ㄋㄋ丶丶
枳	木口ノ丶丶丶
楫	木口一丨一一
枵	木口一ㄋㄋㄋ
樟	木音一丨丨丨
榇	木立一丨丶丶
梓	木辛丶一丨丨
橇	木毛ノ一ㄋㄋ
橘	木矛丨ㄋ一一
楼	木米ㄋノ一一
楂	木木丨ㄋ一一
横	木丨ㄋ丶丶
栝	木舌ノ一一一
棍	木日一ㄋㄋㄋ
植	木直一丨一一
楠	木十丨ㄋ丨丨
枯	木古一丨一一
椟	木十ㄋ丶丶丶
枝	木十ㄋ丶丶丶
桔	木吉一丨一一
柢	木氏丶丶丶丶
梭	木夋ㄋ丶丶丶
楞	木罒丶一ノノ
椤	木罒ノㄋ丶丶
棱	木土ノ丶丶丶
桂	木圭一丨一一
栓	木人一一一一
梧	木五丨ㄋ一一
杪	木小ノノノノ
桓	木一丨ㄋ一一
柄	木丙ノ丶丶丶
柽	木又一丨一一
樗	木雨一一ㄋㄋ
檑	木雨丨ㄋ一一
榻	木日ㄋ丶一一
桴	木爫ㄋ丨一一
格	木各ノㄋ一一
樵	木隹丶丶丶丶
榫	木隹一丨丨丨
桶	木甬ㄋ丶丨丨
杷	木巴ㄋ丨ㄋㄋ
柏	木白ノ丨一一
朴	木卜丨丶丶丶
杯	木不一ノ丶丶
材	木才一丨ノノ
栅	木冂ノㄋ一一
柝	木斤丶丶丶丶
棰	木垂ノ一一一
村	木寸一丨丶丶
梯	木弟丶ノノノ
栋	木东一ㄋ丶丶
枚	木攵ノ一丶丶
枋	木方丶一ノノ
柑	木甘一丨一一
杆	木干一一丨丨
根	木艮ㄋ一丶丶
梗	木更一丨丶丶
杠	木工一丨一一
槐	木鬼ノ丨丶丶
棵	木日一丨丶丶
极	木及ノㄋ丶丶
机	木几ノㄋㄋㄋ
杞	木己ㄋ一ㄋㄋ
柙	木甲丨ㄋ丨丨
栈	木戋一一丶丶
桷	木角ノㄋ丨丨
析	木斤ノノ丨丨
桕	木臼ノ丨一一
朽	木丂一ㄋㄋㄋ
相	相一丨一一
枘	木内丨ㄋ丶丶
枰	木平一丶丨丨
杉	木彡ノノノノ
柘	木石一ノ一一
标	木示一一丶丶
杜	木土一丨一一
枉	木王一一一一
杌	木兀一ノㄋㄋ
栖	木西一丨一一
桠	木亚一丨一一
槠	木讠一丨一一
样	木羊丶ノ丨丨
札	木乚ㄋㄋㄋㄋ
枕	木冖ノㄋㄋㄋ
柚	木由丨ㄋ一一
权	木又ㄋ丶丶丶
树	木又一丨丶丶
杼	木予ㄋ丶丨丨
柞	木乍ノ一一一
枨	木长ノ一丶丶
杖	木一ノ丶丶丶
桃	木儿丶一丶丶
椎	木隹ノ丨一一
枣	朿⺀丶丶丶丶
枢	木区一ノㄋㄋ
桦	木华ノㄋㄋㄋ
森	木林一丨丶丶
查	木旦丨ㄋ一一
桤	木山ㄋ一ㄋㄋ
枪	木仓ノ丶ㄋㄋ
杰	木灬丶丶丶丶
杏	木口丨ㄋ一一
杳	木日丨ㄋ一一
柰	木示一一丶丶
李	木子ㄋ丨一一
㭕	木去一丨丶丶
枅	木开一一丨丨
梌	木余ノ丶丶丶
梠	木口丨ㄋ一一
梾	木夹丨ノ丶丶
棤	木昔一丨一一
棽	林今ノ丶ㄋㄋ
椆	木冂一丨一一
楙	木矛一丨丶丶
榃	林田丨ㄋ一一
榅	木日丨ㄋ一一
榑	木甫一丨丶丶
橑	木尞一ノ丶丶
橦	木立丨ㄋ一一
檞	木角ㄋノ丨丨
瞩	目尸ノ丨丶丶
瞌	目去丨ㄋ一一
瞬	目受ノㄋ丨丨
睛	目青一一一一
盼	目分ノ丶ノノ
瞒	目艹一丨丶丶
瞵	目米ノㄋ丨丨
眨	目丿丶ㄋ丶丶
瞑	目冖丨ㄋ丶丶
睃	目夋ㄋ丶丶丶
眙	目台ㄋ丶一一
眸	目厶ノ一丨丨
瞍	目臼丨ㄋ丶丶
睡	目垂ノ一一一
睇	目弟丶ノノノ
睫	目妻丨一丶丶
眄	目正ㄋㄋㄋㄋ
瞿	目目ノ丨一一
矍	目目ノ丨丶丶
睁	目争ノㄋ丨丨
目	目丨ㄋ一一
氍	目目ノ丨ㄋㄋ
鼎	目丨一ㄋㄋ
眶	目匚一一一一
眍	目区一ノㄋㄋ
瞰	目敢ノ一丶丶
瞅	目禾丶ノ丶丶
眦	目此丨一ㄋㄋ
瞻	目厃ノ丶一一
睚	目厂一丨一一
睥	目卑ノ丨丨丨
睹	目者一丨一一
瞠	目一丨一一
瞎	目宀一一一一
眩	目玄丶一丶丶
睑	目佥ノ丶一一
睽	目癸ㄋ丶丶丶
瞪	目登ㄋ丶一一
瞄	目艹丨ㄋ一一
睨	目臼ノㄋㄋㄋ
瞳	目立丨ㄋ一一
睦	目土ノ丶一一
眭	目圭一丨一一
眵	目夕ノㄋ丶丶
瞟	目覀一一丶丶
眇	目小ノノノノ
睬	目爫一丨丶丶
瞧	目隹丶丶丶丶
盯	目丁一丨丨丨
眼	目艮ㄋ一丶丶
睐	目夹丨ノ丶丶
眯	目米丶ノ丶丶
眠	目民ㄋ一ㄋㄋ
盹	目屯一ㄋㄋㄋ
眈	目冖ノㄋㄋㄋ
盱	目于一一丨丨
眺	目儿丶一丶丶
睢	目隹ノ丨一一
瞭	目尞一ノ丶丶
瞋	目直ノ丶丶丶
眬	目龙一ノ丶丶
眊	目毛ノ一ㄋㄋ
睄	目肖丨丶一一
瞫	目覀丨ㄋ丨丨
睎	目希ノ丶丨丨
鼐	乃目ㄋ一ㄋㄋ
乃	乃ㄋノノノ
戤	乃又丨ㄋ丶丶
盈	乃又丨ㄋ一一
尕	乃小丨ノ丶丶
孕	乃子ㄋ丨一一
内	内丨ㄋ丶丶
朔	屰月ノㄋ一一
逆	屰辶丶ㄋ丶丶
槊	屰月一丨丶丶
塑	屰月一丨一一
世	世一丨ㄋㄋ
廿	廿一丨一一
觐	堇见丨ㄋㄋㄋ
勤	堇力ㄋノノノ
鄞	堇阝ㄋ丨丨丨
堇	堇一丨一一
燕	廿口丨一丶丶
贳	世贝丨ㄋ丶丶
鸟	鸟ノㄋ一一
鸵	鸟宀ノㄋㄋㄋ
鹱	鸟艹ノ丨丶丶
肃	肀ノ丶丶丶
鹔	肀八ノ丨一一
牛	牛ノ一丨丨
牯	牛古一丨一一
牧	牛攵ノ一丶丶
犏	牜户丨ㄋ丨丨
犊	牜十ㄋ丶丶丶
物	牜勿ノㄋノノ
犍	牜聿ㄋ丶丶丶
犒	牜高丶一一一
犋	牜ノ丶丶丶
牿	牜告ノ一一一
犄	牜大一丨丨丨
特	牜土一丨丶丶
牾	牜五丨ㄋ一一
牝	牜匕ノㄋㄋㄋ
牦	牜毛ノ一ㄋㄋ
牲	牜生ノ一一一
牡	牜土一丨一一
牺	牜西一丨一一
媚	女丨ㄋ一一
姹	女宀ノ一ㄋㄋ
嫣	女正一ㄋ丶丶
嫒	女受一ノ丶丶
娩	女免ノㄋㄋㄋ
媾	女冓一一一一
妲	女旦丨ㄋ一一
娼	女日丨ㄋ一一
娌	女里丨ㄋ一一
娃	女圭一丨一一
嫖	女覀一一丶丶
妙	女小ノノノノ
妍	女开一一丨丨
嫂	女臼丨ㄋ丶丶
孀	女雨一丨一一
媪	女日丨ㄋ一一
媛	女爰ノ丶丶丶
媳	女自丶ㄋ丶丶
婊	女ノㄋ丶丶
姬	女一丨一一
姊	女弟ノㄋノノ
姗	女冂丨ㄋ一一
妞	女丑ㄋ丨一一
娣	女弟丶ノノノ
妨	女方丶一ノノ
奸	女干一一丨丨
妒	女户丶ㄋノノ
妃	女己ㄋ一ㄋㄋ
妇	女彐ㄋ一一一
婕	女妻丨一丶丶
如	女口丨ㄋ一一
妈	女马ㄋㄋ一一
姆	女母ㄋㄋ丶丶
奶	女乃ㄋノノノ
姐	女且丨ㄋ一一
姓	女生ノ一一一
妫	女为丶ノ丶丶
妹	女未一一丶丶
娥	女我ノ一丶丶
妩	女一一ノㄋㄋ
娅	女亚一丨一一
她	女也ㄋ丨ㄋㄋ
姨	女大ㄋ一ㄋㄋ
姒	女以ㄋ丶丶丶
奴	奴ㄋノ丶丶
姚	女儿丶一丶丶
好	女子ㄋ丨一一
恕	女口丶ㄋ丶丶
弩	奴弓ㄋ一ㄋㄋ
帑	奴巾丨ㄋ丨丨
努	奴力ㄋノノノ
驽	奴马ㄋㄋ一一
怒	奴心丶ㄋ丶丶
胬	奴又丨ㄋ丶丶
孥	奴子ㄋ丨一一
女	女ㄋノ一一
妪	女区一ノㄋㄋ
姥	女耂ノㄋㄋㄋ
妣	女比一ㄋㄋㄋ
娜	女ㄋ丨丨丨
姝	女丿一一丶丶
嫩	女束ノ一丶丶
婀	女阝一丨丨丨
妁	女勹丶丶丶丶
娴	女门一丨丶丶
姻	女因丨ㄋ一一
嬷	女麻ノㄋ丶丶
嫉	女疒ノ一丶丶
娠	女辰一ノ丶丶
妮	女尸ノㄋㄋㄋ
娓	女尸ノ一ㄋㄋ
婢	女卑ノ丨丨丨
嫱	女十丶ノ一一
娆	女尧一ㄋㄋㄋ
嬗	女亠丨ㄋ一一
嫡	女啇丶一一一
婷	女亮一丨丨丨
嫦	女丨ㄋ丨丨
妗	女今ノ丶ㄋㄋ
婉	女宀ノㄋㄋㄋ
嫔	女宀ノ丨丶丶
婶	女宀丨ㄋ丨丨
嫁	女宀一ノ丶丶
姣	女交丶一丶丶
娇	女夭ノ丨丨丨
嬉	女壴丨ㄋ一一
婿	女疋丨ㄋ一一
婧	女青一一一一
婵	女单丶ノ丨丨
姘	女䒑一ノ丨丨
嫫	女莫一丨丶丶
媸	女蚩ㄋ丨丶丶
娘	女良丶ㄋ丶丶
媒	女甘一丨丶丶
娟	女口丨ㄋ一一
娱	女口一一丶丶
娲	女呙丨ㄋ丶丶
嫜	女音一丨丨丨
妖	女夭ノ一丶丶
妊	女壬ノ一一一
姑	女古一丨一一
妓	女十ㄋ丶丶丶
婚	女氏丨ㄋ一一
始	女台ㄋ丶一一
嫘	女田ㄋㄋ丶丶
娉	女由一ㄋㄋㄋ
嫌	女兼丶ノ丶丶
妯	女由丨ㄋ一一
妤	女予ㄋ丶丨丨
絮	女口ㄋㄋ丶丶
砮	奴石一ノ一一
㛚	女甬ㄋ丶丨丨
妭	女ㄋ丶丶丶
姤	女丨ㄋ一一
姶	女合ノ丶一一
姽	女厃ㄋㄋㄋㄋ
婍	女大一丨丨丨
婤	女冂一丨一一
婫	女日一ㄋㄋㄋ
媂	女帝丨ㄋ丨丨
媓	女白一一一一
媖	女艹丨ㄋ丶丶
媞	女是丨ㄋ丶丶
嫪	女羽ノ丶ノノ
嫽	女尞一ノ丶丶
嬥	女羽ノ丨一一
嬬	女雨一ノ丨丨
戕	爿戈一ㄋ丶丶
奘	爿士一ノ丶丶
爿	爿ㄋ丨ノノ
颇	皮页一ノ丶丶
皮	皮ㄋノ丶丶
辟	辟ㄋ一丨丨
避	辟辶丶ㄋ丶丶
臂	辟⺝丨ㄋ一一
襞	辟衣丶一丶丶
劈	辟刀ㄋノノノ
鐾	辟金ノ丶一一
檗	辟木一丨丶丶
嬖	辟女ㄋノ一一
擘	辟手ノ一丨丨
壁	辟土一丨一一
甓	辟瓦一ㄋ丶丶
璧	辟王丶丶丶丶
譬	辟言丶一一一
牖	片户一丨丶丶
版	片ㄋ丶丶丶
牍	片十ㄋ丶丶丶
牒	片世一丨丶丶
片	片ノ丨ㄋㄋ
牌	片卑ノ丨丨丨
胤	丿幺丨ㄋㄋㄋ
朱	丿未一一丶丶
延	丿止ㄋ丶丶丶
向	向口丨ㄋ一一
囟	囟㐅ノ丶丶丶
囱	囟夂ノㄋ丶丶
奥	向米一ノ丶丶
番	番ノ丶一一
悉	丿米丶ㄋ丶丶
入	入ノ丶丶丶
禹	禹ノ丨丶丶
乇	乇ノ一ㄋㄋ
邾	丿未ㄋ丨丨丨
翻	番羽ㄋ丶一一
鄱	番阝ㄋ丨丨丨
释	丿米ㄋ丶丨丨
衅	丿皿丶ノ丨丨
衄	丿皿ㄋ丨一一
釉	丿米丨ㄋ一一
粤	向米一ㄋㄋㄋ
睾	丿罒一丨一一
丢	丿去一丨丶丶
系	丿糸ㄋㄋ丶丶
升	丿廾一ノ丨丨
币	丿巾丨ㄋ丨丨
血	丿皿丨ㄋ一一
么	丿厶ㄋ丶丶丶
乏	丿之丶ㄋ丶丶
籴	入米丶ノ丶丶
汆	入水丨ㄋ丶丶
鹤	冖隹ノㄋ一一
鸩	冖儿ノㄋ一一
罕	冖八一一丨丨
农	农丶ㄋノノ
皲	冖车ㄋノ丶丶
郓	冖车ㄋ丨丨丨
冤	冖免丶丶丶丶
写	冖与一一一一
冠	冖元一丨丶丶
幂	冖日一ノ丨丨
军	冖车一ㄋ丨丨
冢	冖豕丶丶丶丶
冗	冖几ノㄋㄋㄋ
冥	冖日丶一丶丶
隺	冖隹ノ丨一一
平	平一丶丨丨
切	七刀ㄋノノノ
七	七一ㄋㄋㄋ
其	其一丨丶丶
甚	其乚ㄋㄋㄋㄋ
基	其土一丨一一
欺	其欠ノㄋ丶丶
斯	其斤ノノ丨丨
期	其月ノㄋ一一
斟	其乚丶丶丨丨
戡	其乚一ㄋ丶丶
勘	其乚ㄋノノノ
綦	其糸ㄋㄋ丶丶
惎	其心丶ㄋ丶丶
氤	气因丨ㄋ一一
氨	气宀ㄋノ一一
氦	气亥丶一丶丶
氢	气轻ㄋ丶一一
氯	气录ㄋ一丶丶
氰	气青一一一一
氛	气分ノ丶ノノ
氮	气炎丶ノ丶丶
氲	气日丨ㄋ一一
氡	气夂丶丶丶丶
氘	气ノ丨丨丨
氚	气川ノ丨丨丨
氟	气弓ノ丨丨丨
氖	气乃ㄋノノノ
氕	气丿ノノノノ
氙	气山丨ㄋ丨丨
氩	气亚一丨一一
氧	气羊丶ノ丨丨
气	气ノ一ㄋㄋ
钡	气贝丨ㄋ丶丶
氪	气古ノㄋㄋㄋ
迁	千辶丶ㄋ丶丶
千	千ノ一丨丨
乖	千北丨一ㄋㄋ
鸹	舌鸟ノㄋ一一
舔	舌天丨丶丶丶
辞	舌辛丶一丨丨
刮	舌刂丨丨丨丨
敌	舌攵ノ一丶丶
甜	舌甘一丨一一
舐	舌氏ノㄋㄋㄋ
乱	舌乚ㄋㄋㄋㄋ
歃	千臼ノㄋ丶丶
适	舌辶丶ㄋ丶丶
憩	舌自丶ㄋ丶丶
舌	舌ノ一一一
凵	凵ㄋ丨丨丨
出	出ㄋ丨丨丨
粜	出米丶ノ丶丶
祟	出示一一丶丶
䢺	出阝ㄋ丨丨丨
欠	欠ノㄋ丶丶
助	且力ㄋノノノ
雎	且隹ノ丨一一
且	且丨ㄋ一一
县	且厶ㄋ丶丶丶
悬	且厶丶ㄋ丶丶
静	青争ノㄋ丨丨
青	青一一一一
靓	青见丨ㄋㄋㄋ
靛	青定丶丶丶丶
䴖	青鸟ノㄋ一一
迳	轻辶丶ㄋ丶丶
巯	轻㐬丶一ㄋㄋ
刭	轻刂丨丨丨丨
劲	轻力ㄋノノノ
颈	轻页一ノ丶丶
邱	丘阝ㄋ丨丨丨
丘	丘ノ丨一一
兵	丘八ノ丶丶丶
乓	丘丶丶丶丶丶
乒	丘丿ノノノノ
岳	丘山丨ㄋ丨丨
曲	曲丨ㄋ一一
盍	去皿丨ㄋ一一
去	去一丨丶丶
却	去卩ㄋ丨丨丨
劫	去力ㄋノノノ
弆	去廾一ノ丨丨
犬	犬一ノ丶丶
飙	犬犬一ノ丶丶
从	从ノ丶丶丶
伞	人丷一丨丨丨
耸	从耳一丨一一
怂	从心丶ㄋ丶丶
丛	从一一一一一
会	人云一一丶丶
畲	人示丨ㄋ一一
介	人ノ丨丨丨
仑	人匕ノㄋㄋㄋ
全	人王一一一一
仓	仓ノ丶ㄋㄋ
企	人止丨一一一
人	人ノ丶丶丶
坐	从土一丨一一
氽	人水丨ㄋ丶丶
刽	人云丨丨丨丨
郐	人云ㄋ丨丨丨
俎	从且丨ㄋ一一
创	仓刂丨丨丨丨
戗	仓戈一ㄋ丶丶
禽	人㐫丨ㄋ丶丶
食	食ノ丶丶丶
仝	人工一丨一一
众	人从ノ丶丶丶
佘	人示一一丶丶
个	人丨丨丨丨丨
鸧	仓鸟ノㄋ一一
廷	壬廴ㄋ丶丶丶
壬	壬ノ一一一
颋	壬廴一ノ丶丶
暾	日享ノ一丶丶
晰	日木ノノ丨丨
昀	日勹丶一一一
晌	日向丨ㄋ一一
昵	日尸ノㄋㄋㄋ
曦	日ノ一丶丶
晓	日尧一ㄋㄋㄋ
晔	日华ノㄋㄋㄋ
曜	日羽ノ丨一一
晗	日今丨ㄋ一一
晾	日京丶一丶丶
暄	日㝉丨ㄋ一一
暧	日受一ノ丶丶
晦	日每ノ一丶丶
晚	日免ノㄋㄋㄋ
晴	日青一一一一
昭	日召ㄋノ一一
暗	日音丶一一一
晖	日冖一ㄋ丨丨
暝	日冖丨ㄋ丶丶
曝	日日一丨丶丶
曙	日罒一丨一一
暖	日爰ノ丶丶丶
时	日寸一丨丶丶
晡	日甫一丨丶丶
旰	日干一一丨丨
旷	日广丶一ノノ
暇	日叚ㄋ一丶丶
昕	日斤ノノ丨丨
旺	日王一一一一
昧	日未一一丶丶
曛	日千丨ㄋ丶丶
映	日央丨ㄋ丶丶
明	日月ノㄋ一一
昨	日乍ノ一一一
畅	日丨ㄋノノノ
匙	是匕ノㄋㄋㄋ
韪	是韦一一丨丨
题	是页一ノ丶丶
遢	日羽丶ㄋ丶丶
暹	日隹丶ㄋ丶丶
冕	日免ノㄋㄋㄋ
冒	日目丨ㄋ一一
煦	日句丶丶丶丶
照	日召丶丶丶丶
盟	日月丨ㄋ一一
量	旦里丨ㄋ一一
晨	日辰一ノ丶丶
曼	日罒ㄋ丶丶丶
日	日丨ㄋ一一
电	日乚ㄋㄋㄋㄋ
果	日木一丨丶丶
申	日丨丨丨丨丨
禺	禺丨ㄋ丶丶
曳	曳丨ㄋノノ
勖	日目ㄋノノノ
剔	日勿丨丨丨丨
影	日京ノノノノ
颢	日京一ノ丶丶
戥	日生一ㄋ丶丶
夥	日木ノㄋ丶丶
颗	日木一ノノノ
暌	日癸ㄋ丶丶丶
晤	日五丨ㄋ一一
晒	日西一丨一一
遇	禺辶丶ㄋ丶丶
昴	日卯ㄋ丨丨丨
昂	日ㄋ丨丨丨
昆	日比一ㄋㄋㄋ
最	日耳ㄋ丶丶丶
晶	日日丨ㄋ一一
易	日勿ノㄋノノ
晟	日戊ㄋㄋㄋㄋ
昃	日厂ノ丶丶丶
暑	日者一丨一一
晷	日夂丨丶丶丶
景	日京丶一丶丶
晃	日光丨丶ㄋㄋ
晏	日宀ㄋノ一一
曩	日襄丶一丶丶
昙	日云一一丶丶
昊	日天一一丶丶
暴	日共丨丶丶丶
是	是丨ㄋ丶丶
旱	日干一一丨丨
炅	日火丶ノ丶丶
旯	日九ノㄋㄋㄋ
昱	日立丶一一一
杲	日木一丨丶丶
晕	日冖一ㄋ丨丨
星	日生ノ一一一
显	日业丨丨一一
昌	日日丨ㄋ一一
晁	日儿丶一丶丶
愚	禺心丶ㄋ丶丶
颙	禺页一ノ丶丶
鹍	日比ノㄋ一一
旴	日于一一丨丨
旸	日汤ㄋノノノ
昈	日户丶ㄋノノ
昡	日亠ㄋㄋ丶丶
昣	日㐱ノ丶ノノ
昫	日句ノㄋ一一
昽	日龙一ノ丶丶
晊	日至一ㄋ一一
晐	日亥丶一丶丶
晞	日希ノ丶丨丨
曈	日立丨ㄋ一一
三	三一一一一
须	彡页一ノ丶丶
沤	氵区一ノㄋㄋ
溉	氵一ㄋㄋㄋ
泖	氵卯ㄋ丨丨丨
溺	氵弓丶一一一
测	氵贝丨丨丨丨
涮	氵尸丨ㄋ丨丨
澌	氵其ノノ丨丨
渤	氵孛ㄋ丨ノノ
激	氵白丶一丶丶
潞	氵ノㄋ一一
淑	氵上丨ノ丶丶
瀚	氵ノ丶一一
潮	氵ノㄋ一一
澎	氵壴ノノノノ
澉	氵敢ノ一丶丶
濒	氵止丨ノ丶丶
洌	氵歹丨丨丨丨
濮	氵亻丨丨一一
潴	氵犭一丨一一
淤	氵方ノ丶丶丶
漩	氵族ㄋ丨丶丶
游	氵族ㄋ丨一一
泓	氵弓ㄋ丶丶丶
涨	氵弓ノ一丶丶
潲	氵禾丨丶一一
湫	氵禾丶ノ丶丶
潍	氵纟ノ丨一一
淞	氵木ノ丶丶丶
淅	氵木ノノ丨丨
淋	氵林一丨丶丶
湘	氵相一丨一一
渺	氵目丨ノノノ
濉	氵目ノ丨一一
溯	氵屰ノㄋ一一
洳	氵女丨ㄋ一一
洙	氵丿一一丶丶
沏	氵七ㄋノノノ
漱	氵束ノㄋ丶丶
濑	氵束ノㄋ丶丶
浙	氵折一丨丨丨
浒	氵讠ノ一丨丨
淝	氵月ㄋ丨ㄋㄋ
泐	氵阝ㄋノノノ
湃	氵一一丨丨
汤	氵汤ㄋノノノ
淘	氵勹ノ一丨丨
洵	氵勹丨ㄋ一一
沟	氵勹ㄋ丶丶丶
泡	氵勹ㄋ一ㄋㄋ
沭	氵木丶丶丶丶
涎	氵丿丨一丶丶
涟	氵车丶ㄋ丶丶
溅	氵贝一一丶丶
汰	氵大丶丶丶丶
澜	氵门一丨丶丶
涧	氵门丨ㄋ一一
润	氵门一一一一
洞	氵冂丨ㄋ一一
溧	氵覀一丨丶丶
漂	氵覀一一丶丶
湮	氵覀一丨一一
沧	氵仓ノ丶ㄋㄋ
沙	氵小ノノノノ
洹	氵一丨ㄋ一一
沅	氵元一一ㄋㄋ
溲	氵臼丨ㄋ丶丶
泽	氵又一一丨丨
溻	氵日ㄋ丶一一
渴	氵曷丨ㄋㄋㄋ
温	氵日丨ㄋ一一
漫	氵日丨ㄋ丶丶
涅	氵日一丨一一
洧	氵丨ㄋ一一
淫	氵爫ノ一一一
滔	氵爫ノ丨一一
溪	氵爫ㄋㄋ丶丶
浮	氵爫ㄋ丨一一
洛	氵各ノㄋ一一
洚	氵夂一ㄋ丨丨
涤	氵夂一丨丶丶
涉	氵止丨ノノノ
濞	氵自丨ㄋ丨丨
溴	氵自一ノ丶丶
涌	氵甬ㄋ丶丨丨
渍	氵丨ㄋ丶丶
洪	氵共一丨丶丶
湔	氵前丶ノ丨丨
派	氵ノㄋ丶丶
渊	氵丶ノ丶丶
泊	氵白ノ丨一一
泌	氵必丶ㄋ丶丶
渐	氵车ノノ丨丨
浊	氵虫丨ㄋ丶丶
涿	氵豕丶丶丶丶
涕	氵弟丶ノノノ
洱	氵耳一丨一一
汇	氵匚一ㄋㄋㄋ
滟	氵丰ノㄋㄋㄋ
沣	氵丰一一丨丨
沛	氵一丨ㄋ丨丨
沸	氵弓ノ丨丨丨
浦	氵甫一丨丶丶
泔	氵甘一丨一一
汗	氵干一一丨丨
江	氵工一丨一一
沪	氵户丶ㄋノノ
汲	氵及ノㄋ丶丶
泺	氵丨ノ丶丶
泷	氵龙一ノ丶丶
沔	氵正ㄋㄋㄋㄋ
湎	氵丆丨ㄋ一一
泯	氵民ㄋ一ㄋㄋ
泳	氵永丶ㄋ丶丶
汩	氵囗一一一一
洮	氵儿丶一丶丶
渠	氵匚ㄋ一丶丶
烫	氵汤丶ノ丶丶
懑	氵艹一丨丶丶
裟	氵小ノ丶丶丶
鲨	氵小ノノ一一
娑	氵小ノㄋ一一
挲	氵小ノノ丨丨
粱	氵刀ノ丶丶丶
梁	氵刀ノ丶丶丶
染	氵九一丨丶丶
婆	氵皮ㄋノ一一
沲	氵ㄋ丨ㄋㄋ
渖	氵宀丨ㄋ丨丨
溆	氵余ㄋ丶丶丶
灏	氵日丶一丶丶
鸿	氵工ノㄋ一一
浏	氵文丨丨丨丨
潋	氵佥ノ一丶丶
湖	氵古ノㄋ一一
漪	氵犭一ノ丨丨
滁	氵阝ノ丶丶丶
河	氵可一丨丨丨
涸	氵囗一丨一一
洇	氵因丨ㄋ一一
洄	氵回丨ㄋ一一
泅	氵囗ノ丶丶丶
溷	氵囗一ノ丶丶
涠	氵囗一一丨丨
汊	氵又丶丶丶丶
泼	氵发ㄋノ丶丶
澹	氵厃ノ丶一一
涛	氵一丨丶丶
滹	氵虍ノ丶丨丨
滤	氵虍丶ㄋ丶丶
漉	氵鹿丶一ㄋㄋ
源	氵厂ノ丨丶丶
涯	氵厂一丨一一
沥	氵厂ㄋノノノ
渡	氵度ㄋ丶丶丶
溏	氵广ㄋ一一一
濂	氵广丶ノ丶丶
湄	氵丨ㄋ一一
渥	氵尸一ㄋ一一
潺	氵尸ㄋ丨一一
泥	氵尸ノㄋㄋㄋ
漏	氵尸一丨丶丶
涵	氵了丶一丨丨
汹	氵乂ㄋ丨丨丨
渗	氵叁ノノノノ
漕	氵曹一丨一一
滞	氵带一丨丨丨
溃	氵贵丨ㄋ丶丶
渚	氵者一丨一一
浴	氵谷ノ丶一一
淇	氵其一丨丶丶
浇	氵尧一ㄋㄋㄋ
滥	氵监丨ㄋ一一
溜	氵留丨ㄋ一一
瀣	氵⺊ノㄋ一一
潜	氵夫一一丶丶
潸	氵林丨ㄋ一一
漤	氵林ㄋノ一一
濯	氵羽ノ丨一一
涩	氵刀丶丶丶丶
溽	氵辰一丨丶丶
湛	氵其ㄋㄋㄋㄋ
澶	氵亠丨ㄋ一一
漓	氵㐫丨ㄋ丶丶
瀛	氵赢ㄋノ一一
湾	氵亦ㄋ一ㄋㄋ
滦	氵亦一丨丶丶
滴	氵啇丶一一一
滂	氵帝丶一ノノ
淳	氵享丶一一一
濠	氵亮一ノ丶丶
港	氵共ㄋ一ㄋㄋ
湓	氵分丨ㄋ一一
泠	氵令ノ丶丶丶
溶	氵宀ノ丶一一
滓	氵宀丶一丨丨
滨	氵宀ノ丨一一
渲	氵㝉丨ㄋ一一
浣	氵宀一一ㄋㄋ
演	氵㝉丨ㄋ丶丶
淀	氵定丶丶丶丶
沱	氵宀ノㄋㄋㄋ
泞	氵宀一丨丨丨
淙	氵宀一一丶丶
涫	氵宀丨ㄋ一一
液	氵夜丶一丶丶
滚	氵六ㄋ丶丶丶
沆	氵亠ノㄋㄋㄋ
澈	氵丨ㄋ丶丶
泫	氵玄丶一丶丶
浍	氵人一一丶丶
澡	氵口丨ㄋ丶丶
澳	氵向丶ノ丶丶
潘	氵番ノ丶一一
溘	氵去丨ㄋ一一
瀹	氵合丨ㄋ丨丨
渝	氵俞ノ丶丨丨
洽	氵合ノ丶一一
涂	氵余ノ丶丶丶
添	氵天丨丶丶丶
潦	氵尞一ノ丶丶
泾	氵轻ㄋ丶一一
滑	氵骨丨ㄋ一一
渌	氵录ㄋ一丶丶
溢	氵䒑ノ丶一一
流	氵㐬丶一ㄋㄋ
海	氵每ノ一丶丶
汽	氵气ノ一ㄋㄋ
汔	氵ㄋㄋㄋㄋ
浼	氵免ノㄋㄋㄋ
渔	氵鱼ノㄋ一一
涣	氵丨ㄋ丶丶
消	氵肖丨丶一一
淌	氵尚丨丶一一
清	氵青一一一一
洗	氵先ノ一ㄋㄋ
浩	氵告ノ一一一
溱	氵ノ一丶丶
滗	氵ノ一ㄋㄋ
漾	氵丶ㄋ丶丶
汾	氵分ノ丶ノノ
湟	氵白一一一一
沦	氵人ノㄋㄋㄋ
澄	氵登ㄋ丶一一
浈	氵⺊丨ㄋ丶丶
淖	氵卓丨一丨丨
泸	氵⺊ㄋ一ノノ
沾	氵占丨一一一
漠	氵莫一丨丶丶
满	氵艹一丨丶丶
潆	氵劳ㄋㄋ丶丶
涝	氵劳ㄋノノノ
滢	氵劳一一丶丶
漭	氵艹一ノ丶丶
潇	氵艹ㄋ一丶丶
灌	氵艹丨ㄋ一一
淄	氵巛丨ㄋ一一
漶	氵口丨ㄋ一一
淹	氵大丨ㄋㄋㄋ
沼	氵召ㄋノ一一
浪	氵良丶ㄋ丶丶
注	氵主丶一一一
汴	氵丶一丨丶丶
滠	氵耳ㄋ丶丶丶
污	氵亏一一ㄋㄋ
溥	氵甫一丨丶丶
滏	氵父一一一一
淡	氵炎丶ノ丶丶
沿	氵几丨ㄋ一一
没	氵殳ノㄋ丶丶
浔	氵彐一丨丶丶
浸	氵彐丶ㄋ丶丶
涓	氵口丨ㄋ一一
渑	氵口丨ㄋ一一
涡	氵呙丨ㄋ丶丶
浞	氵足丨ㄋ丶丶
漳	氵音一丨丨丨
潼	氵立丨ㄋ一一
涪	氵立丨ㄋ一一
瀵	氵米丨ㄋ丶丶
渣	氵木丨ㄋ一一
漆	氵木ノ丶丶丶
潢	氵丨ㄋ丶丶
沃	氵夭ノ一丶丶
洫	氵丿丨ㄋ一一
泛	氵丿丶ㄋ丶丶
深	氵冖ノ丶丶丶
泻	氵冖一一一一
浑	氵冖一ㄋ丨丨
沉	氵冖ノㄋㄋㄋ
溟	氵冖丶一丶丶
活	氵舌ノ一一一
浜	氵丘ノ丶丶丶
澧	氵曲一丨一一
混	氵日一ㄋㄋㄋ
瀑	氵日一丨丶丶
湿	氵日丨丨一一
涔	氵山ノ丶ㄋㄋ
湍	氵山一ノ丨丨
滇	氵直ノ丶丶丶
淬	氵卒丶一丨丨
沽	氵古一丨一一
渎	氵十ㄋ丶丶丶
洁	氵吉一丨一一
澍	氵壴一丨丶丶
渫	氵世一丨丶丶
浚	氵夋ㄋ丶丶丶
治	氵台ㄋ丶一一
渭	氵田丨ㄋ一一
漯	氵田ㄋㄋ丶丶
淠	氵畀丨ㄋ丨丨
法	氵去一丨丶丶
洼	氵圭一丨一一
济	氵文ノ丨丨丨
浠	氵希ノ丶丨丨
淆	氵㐅一ノ一一
浯	氵五丨ㄋ一一
潭	氵覀丨ㄋ丨丨
灞	氵雨一丨一一
濡	氵雨一ノ丨丨
滋	氵䒑ㄋㄋ丶丶
泮	氵半丶ノ丨丨
汀	氵丁一丨丨丨
浃	氵夹ノ丶丶丶
浅	氵戋一一丶丶
沂	氵斤ノノ丨丨
淦	氵金ノ丶一一
涞	氵夹丨ノ丶丶
泣	氵立丶一一一
沫	氵未一一丶丶
沐	氵木一丨丶丶
泪	氵目丨ㄋ一一
浓	氵农丶ㄋノノ
汝	氵女ㄋノ一一
波	氵皮ㄋノ丶丶
沮	氵且丨ㄋ一一
汨	氵日丨ㄋ一一
汕	氵山丨ㄋ丨丨
汁	氵十一丨丨丨
泄	氵世一丨ㄋㄋ
涑	氵束一丨丶丶
汜	氵巳ㄋ一ㄋㄋ
泗	氵四丨ㄋ一一
沌	氵屯一ㄋㄋㄋ
汪	氵王一一一一
沩	氵为丶ノ丶丶
汶	氵文丶一丶丶
汐	氵夕ノㄋ丶丶
洒	氵西一丨一一
沁	氵心丶ㄋ丶丶
汛	氵乙一丨丨丨
泱	氵央丨ㄋ丶丶
洋	氵羊丶ノ丨丨
池	氵也ㄋ丨ㄋㄋ
沈	氵冖ノㄋㄋㄋ
油	氵由丨ㄋ一一
酒	氵酉一丨一一
汉	氵又ㄋ丶丶丶
滩	氵又ノ丨一一
津	氵聿ㄋ一丨丨
洲	氵川丶丶丶丶
淮	氵隹ノ丨一一
洎	氵自ノ丨一一
鎏	氵㐬丶一ㄋㄋ
鋈	氵夭ノ丶一一
柒	氵七一丨丶丶
薢	氵角ㄋノ丨丨
汧	氵开一一丨丨
沨	氵风ノㄋ丶丶
泂	氵冂丨ㄋ一一
泃	氵句ノㄋ一一
泚	氵此丨一ㄋㄋ
洈	氵厃ㄋㄋㄋㄋ
湑	氵疋丨ㄋ一一
湜	氵是丨ㄋ丶丶
溍	氵亚丨ㄋ一一
滃	氵公ㄋ丶一一
滆	氵鬲一丨丨丨
漈	氵祭ノㄋ丶丶
漻	氵羽ノ丶ノノ
潏	氵矛丨ㄋ一一
澥	氵角ㄋノ丨丨
濩	氵艹ノ丨丶丶
瀌	氵鹿丶丶丶丶
瀼	氵襄丶一丶丶
嵋	山丨ㄋ一一
崛	山尸ㄋ丨丨丨
嵴	山ノ丶一一
峭	山肖丨丶一一
崂	山劳ㄋノノノ
嵘	山劳一丨丶丶
崦	山大丨ㄋㄋㄋ
嶙	山米ノㄋ丨丨
嵝	山米ㄋノ一一
岐	山十ㄋ丶丶丶
峻	山夋ㄋ丶丶丶
峙	山土一丨丶丶
崤	山㐅一ノ一一
崾	山覀ㄋノ一一
岍	山开一一丨丨
峄	山又一一丨丨
峰	山夂一一丨丨
嵊	山禾丨一ㄋㄋ
屺	山已ㄋ一ㄋㄋ
峡	山夹ノ丶丶丶
岬	山甲丨ㄋ丨丨
崃	山夹丨ノ丶丶
岷	山民ㄋ一ㄋㄋ
峨	山我ノ一丶丶
岈	山牙一ㄋノノ
峥	山争ノㄋ丨丨
山	山丨ㄋ丨丨
幽	山幺ㄋㄋ丶丶
豳	山豕一ノ丶丶
酆	山丰一一丨丨
觊	山己丨ㄋㄋㄋ
剀	山己丨丨丨丨
凯	山己ノㄋㄋㄋ
颛	山雨一ノ丶丶
刿	山夕丨丨丨丨
岖	山区一ノㄋㄋ
屿	山与一一一一
岣	山句ノㄋ一一
峋	山勹丨ㄋ一一
岘	山见丨ㄋㄋㄋ
峒	山冂丨ㄋ一一
嵯	山一丨一一
峪	山谷ノ丶一一
崆	山穴一丨一一
崞	山享丶一一一
岭	山令ノ丶丶丶
峤	山夭ノ丨丨丨
屹	山ㄋㄋㄋㄋ
嶝	山登ㄋ丶一一
崎	山大一丨丨丨
嶂	山音一丨丨丨
岵	山古一丨一一
嵫	山䒑ㄋㄋ丶丶
岫	山由丨ㄋ一一
遄	山而丶ㄋ丶丶
峁	山卯ㄋ丨丨丨
嶷	山疑ノㄋ丶丶
巍	山禾ㄋノ丶丶
巅	山直ノ丶丶丶
岿	山ㄋ一一一
崭	山车ノノ丨丨
嵌	山甘ノㄋ丶丶
崧	山木ノ丶丶丶
崩	山月ノㄋ一一
岢	山可一丨丨丨
崴	山戊一ㄋ一一
嵩	山高丶一一一
岚	山风ノㄋ丶丶
岗	山冈丨ㄋ丶丶
崮	山囗一丨一一
崖	山厂一丨一一
岸	山厂一一丨丨
炭	山丶ノ丶丶
岑	山今ノ丶ㄋㄋ
崇	山宀一一丶丶
嵛	山俞ノ丶丨丨
崽	山田丶ㄋ丶丶
岜	山巴ㄋ丨ㄋㄋ
岽	山东一ㄋ丶丶
嵬	山鬼ノ丨丶丶
岌	山及ノㄋ丶丶
岂	山己ㄋ一ㄋㄋ
岩	山石一ノ一一
岁	山夕ノㄋ丶丶
崔	山隹ノ丨一一
翙	山夕ㄋ丶一一
酅	山隹丨ㄋ丨丨
屼	山兀一ノㄋㄋ
岞	山乍ノ一一一
岠	山匚ㄋ一一一
峗	山厃ㄋㄋㄋㄋ
峿	山五丨ㄋ一一
崌	山尸一丨一一
崒	山卒丶一丨丨
崚	山土ノ丶丶丶
嵅	山咸一ノ丶丶
嵎	山禺丨ㄋ丶丶
嵖	山木丨ㄋ一一
嶍	山羽ノ丨一一
嶒	山曾丶ノ一一
嶓	山番ノ丶一一
嶦	山厃ノ丶一一
督	上小ㄋ丶一一
上	上丨一一一
叔	上小ㄋ丶丶丶
卡	上卜丨丶丶丶
忐	上心丶ㄋ丶丶
躯	身匚ノ丶丶丶
躺	身尚丨丶一一
躲	身几一丨丶丶
射	身寸一丨丶丶
躬	身弓ㄋ一ㄋㄋ
身	身ノ丨ノノ
甥	生田ㄋノノノ
生	生ノ一一一
眚	生目丨ㄋ一一
迟	尺辶丶ㄋ丶丶
昼	尺旦丨ㄋ一一
咫	尺口丨ㄋ丶丶
局	尸丨ㄋ一一
屁	尸比一ㄋㄋㄋ
履	尸彳ノ一丶丶
屦	尸彳丶ノ一一
屐	尸彳一丨丶丶
屣	尸彳丨一丶丶
犀	尸氺ノ一丨丨
屠	尸者一丨一一
屋	尸至一ㄋ一一
屑	尸肖丨丶一一
屏	尸䒑一ノ丨丨
层	尸云一一丶丶
屡	尸米ㄋノ一一
羼	尸羊丶ノ丨丨
孱	尸子ㄋ丨一一
尼	尸匕ノㄋㄋㄋ
屈	尸出ㄋ丨丨丨
尻	尸九ノㄋㄋㄋ
尾	尸毛ノ一ㄋㄋ
屎	尸米丶ノ丶丶
屉	尸世一丨ㄋㄋ
尿	尸水丨ㄋ丶丶
属	尸禹ノ丨丶丶
熨	尸示一丨丶丶
慰	尸示一丨丶丶
尺	尺ㄋ一丶丶
尸	尸ㄋ一ノノ
剧	尸古丨丨丨丨
刷	尸巾丨丨丨丨
尉	尸示一丨丶丶
殿	尸共ノㄋ丶丶
屙	尸阝一丨丨丨
展	尸ㄋノ丶丶
居	尸古一丨一一
届	尸由丨ㄋ一一
尽	尺⺀丶丶丶丶
螱	尸示一丨丶丶
屃	尸贝丨ㄋ丶丶
博	十甫一丨丶丶
协	十力ノ丶丶丶
裁	衣丶一丶丶
戴	田一丨丶丶
载	车一ㄋ丨丨
哉	口丨ㄋ一一
栽	木一丨丶丶
截	隹ノ丨一一
翅	十又ㄋ丶一一
丧	十䒑ㄋノ丶丶
赍	十从丶ㄋ丶丶
矗	直直一丨一一
贲	十艹丨ㄋ丶丶
孛	孛子ㄋ丨一一
十	十一丨丨丨
鹁	孛子ノㄋ一一
勃	孛子ㄋノノノ
献	十冂丶ノ丶丶
颠	直八一ノ丶丶
翰	人ㄋ丶一一
乾	ㄋㄋㄋㄋ
斡	人丶丶丨丨
戟	戈一ㄋ丶丶
韩	韦一一丨丨
朝	月ノㄋ一一
觌	十买丨ㄋㄋㄋ
啬	十䒑丨ㄋ一一
索	孛糸ㄋㄋ丶丶
直	直一丨一一
南	十冂丶ノ丨丨
真	直八ノ丶丶丶
卉	十廾一ノ丨丨
卖	十买ㄋ丶丶丶
支	十又ㄋ丶丶丶
疐	孛田ㄋ丨丶丶
百	百一ノ一一
夏	丆目ノㄋ丶丶
不	不一ノ丶丶
面	丆囬丨ㄋ一一
而	而一ノ丨丨
戛	丆目一ㄋ丶丶
馓	饣丨ㄋ丶丶
饰	饣丨ㄋ丨丨
饲	饣丨ㄋ一一
饧	饣汤ㄋノノノ
饱	饣勹ㄋ一ㄋㄋ
饷	饣向丨ㄋ一一
馐	饣ㄋ丨一一
饭	饣ㄋ丶丶丶
饮	饣欠ノㄋ丶丶
馈	饣贵丨ㄋ丶丶
饶	饣尧一ㄋㄋㄋ
馔	饣巳ㄋ一丶丶
馋	饣免丶丶丶丶
馆	饣宀丨ㄋ一一
饺	饣交丶一丶丶
饽	饣孛ㄋ丨一一
饬	饣ㄋノノノ
饩	饣气ノ一ㄋㄋ
馅	饣ノ丨一一
饼	饣䒑一ノ丨丨
馍	饣莫一丨丶丶
馇	饣木丨ㄋ一一
馑	饣堇一丨一一
饪	饣壬ノ一一一
馄	饣日一ㄋㄋㄋ
饴	饣台ㄋ丶一一
馊	饣臼丨ㄋ丶丶
馒	饣日丨ㄋ丶丶
馁	饣爫ㄋノ一一
蚀	饣虫丨ㄋ丶丶
饵	饣耳一丨一一
饥	饣几ノㄋㄋㄋ
饯	饣戋一一丶丶
饨	饣屯一ㄋㄋㄋ
饿	饣我ノ一丶丶
馀	饣余ノ丶丶丶
馕	饣橐丨ㄋ丶丶
馏	饣留丨ㄋ一一
饫	饣夭ノ一丶丶
馃	饣日一丨丶丶
饸	饣合ノ丶一一
饹	饣各ノㄋ一一
馉	饣骨丨ㄋ一一
饳	饣出ㄋ丨丨丨
饻	饣衣丶一丶丶
砸	石匚丨ㄋ丨丨
礅	石享ノ一丶丶
硎	石开丨丨丨丨
砒	石比一ㄋㄋㄋ
砌	石七ㄋノノノ
硼	石月ノㄋ一一
砀	石汤ㄋノノノ
矾	石凡ノㄋ丶丶
硐	石冂丨ㄋ一一
砜	石风ノㄋ丶丶
碱	石咸一ノ丶丶
硇	石囟ノ丶丶丶
磋	石一丨一一
砺	石厂一ㄋノノ
碥	石户丨ㄋ丨丨
碾	石尸一丨丶丶
碜	石叁ノノノノ
碘	石曲ノ丶丶丶
砍	石欠ノㄋ丶丶
硗	石尧一ㄋㄋㄋ
磲	石氵一ㄋ丶丶
磔	石舛一丨丶丶
碲	石帝丨ㄋ丨丨
磅	石帝丶一ノノ
碗	石宀ノㄋㄋㄋ
碇	石定丶丶丶丶
砣	石宀ノㄋㄋㄋ
磙	石六ㄋ丶丶丶
磕	石去丨ㄋ一一
礓	石一丨ㄋ一一
磉	石又ㄋ丶丶丶
碌	石录ㄋ一丶丶
硝	石肖丨丶一一
砧	石占丨一一一
礴	石落一丨丶丶
硭	石艹丶一ㄋㄋ
礞	石劳一一丶丶
砹	石艹ノ丶丶丶
砼	石人一丨一一
碚	石立丨ㄋ一一
磷	石米ノㄋ丨丨
碴	石木丨ㄋ一一
砭	石丿丶ㄋ丶丶
碳	石山一ノ丶丶
碎	石卒丶一丨丨
砥	石氏丶丶丶丶
碟	石世一丨丶丶
碹	石㝉丨ㄋ一一
砝	石去一丨丶丶
硅	石圭一丨一一
砂	石小ノノノノ
研	石开一一丨丨
碣	石曷丨ㄋㄋㄋ
碍	石旦一丨丶丶
硌	石各ノㄋ一一
礁	石隹丶丶丶丶
碛	石丨ㄋ丶丶
碡	石ㄋㄋ丶丶
砗	石车一ㄋ丨丨
础	石出ㄋ丨丨丨
矸	石干一一丨丨
硬	石更一丨丶丶
矿	石广丶一ノノ
矶	石几ノㄋㄋㄋ
硖	石夹丨ノ丶丶
确	石角ノㄋ丨丨
斫	石斤ノノ丨丨
砾	石丨ノ丶丶
砬	石立丶一一一
码	石马ㄋㄋ一一
破	石皮ㄋノ丶丶
砰	石平一丶丨丨
砷	石日丨丨丨丨
砘	石屯一ㄋㄋㄋ
硪	石我ノ一丶丶
砑	石牙一ㄋノノ
硕	石页一ノ丶丶
砟	石乍ノ一一一
砖	石专一一丶丶
碓	石隹ノ丨一一
石	石一ノ一一
磺	石丨ㄋ丶丶
矽	石夕ノㄋ丶丶
砩	石弓ノ丨丨丨
礤	石艹ㄋ丶丶丶
砚	石见丨ㄋㄋㄋ
碉	石冂一丨一一
碑	石卑ノ丨丨丨
硫	石㐬丶一ㄋㄋ
磴	石登ㄋ丶一一
磁	石䒑ㄋㄋ丶丶
碰	石並丶ノ一一
硒	石西一丨一一
磊	石石一ノ一一
泵	石水丨ㄋ丶丶
碶	石丰ㄋノ丶丶
磻	石番ノ丶一一
礌	石雨丨ㄋ一一
矻	石ㄋㄋㄋㄋ
硚	石夭ノ丨丨丨
硁	石轻ㄋ丶一一
磜	石祭ノㄋ丶丶
磡	石其ㄋㄋノノ
硙	石山ㄋ一ㄋㄋ
碃	石青一一一一
磹	石覀丨ㄋ丨丨
硊	石厃ㄋㄋㄋㄋ
砫	石主丶一一一
碏	石昔一丨一一
碨	石田一ㄋ丶丶
磏	石兼丶ノ丶丶
砄	石夬ㄋ一丶丶
硔	石共一丨丶丶
矩	矢匚ㄋ一一一
矧	矢弓丨丨丨丨
矮	矢禾ㄋノ一一
短	矢豆一丨一一
知	矢口丨ㄋ一一
雉	矢隹ノ丨一一
矬	矢从一丨一一
智	矢口丨ㄋ一一
矢	矢ノ一丶丶
矫	矢夭ノ丨丨丨
矰	矢曾丶ノ一一
逐	豕辶丶ㄋ丶丶
燹	豕豕丶ノ丶丶
豕	豕一ノ丶丶
豨	豕希ノ丶丨丨
馨	士ノㄋ一一
罄	士ノㄋ丨丨
磬	士ノㄋ一一
瞽	壴十ㄋ丶一一
甏	壴彡一ㄋ丶丶
熹	壴口丶丶丶丶
嘉	壴加ㄋノ一一
士	士一丨一一
謦	士ノㄋ一一
毂	壳车ノㄋ丶丶
彀	壳一ㄋ一丶丶
觳	壳一ノㄋ丶丶
颉	吉页一ノ丶丶
鼓	壴十ㄋ丶丶丶
彭	壴彡ノノノノ
懿	壳豆丶一丶丶
款	士示ノㄋ丶丶
鼙	壴十ㄋ丶丨丨
喜	壴口丨ㄋ一一
壳	壳几ノㄋㄋㄋ
悫	壳几丶ㄋ丶丶
声	士ㄋ丨ノノ
吉	吉一丨一一
壹	壳豆一丨一一
壶	壳业丨丨一一
志	士心丶ㄋ丶丶
縠	壳一ㄋㄋ丶丶
榖	壳一一丨丶丶
祠	礻丨ㄋ一一
祢	礻尔ノㄋ丶丶
祺	礻其一丨丶丶
禊	礻丰ㄋノ丶丶
禧	礻壴丨ㄋ一一
禄	礻录ㄋ一丶丶
禅	礻单丶ノ丨丨
祯	礻⺊丨ㄋ丶丶
祝	礻口ノㄋㄋㄋ
祸	礻呙丨ㄋ丶丶
祗	礻氏丶丶丶丶
祛	礻去一丨丶丶
禚	礻丶丶丶丶
祆	礻夭ノ一丶丶
福	礻同丨ㄋ一一
祓	礻ㄋ丶丶丶
祈	礻斤ノノ丨丨
祖	礻且丨ㄋ一一
神	礻日丨丨丨丨
祀	礻巳ㄋ一ㄋㄋ
社	礻土一丨一一
祥	礻羊丶ノ丨丨
礼	礻乚ㄋㄋㄋㄋ
祚	礻乍ノ一一一
祧	礻儿丶一丶丶
祉	礻止丨一一一
祁	礻阝ㄋ丨丨丨
襟	礻林一一丶丶
视	礻见丨ㄋㄋㄋ
禳	礻襄丶一丶丶
祜	礻古一丨一一
祐	礻丨ㄋ一一
祇	礻氏ノㄋㄋㄋ
祕	礻必丶ㄋ丶丶
祎	礻韦一一丨丨
祏	礻石一ノ一一
谞	讠疋丨ㄋ一一
禛	礻直ノ丶丶丶
祼	礻日一丨丶丶
禋	礻覀一丨一一
禘	礻帝丨ㄋ丨丨
祋	礻殳ノㄋ丶丶
祃	礻马ㄋㄋ一一
祲	礻彐丶ㄋ丶丶
禤	礻罒ㄋ丶一一
祾	礻土ノ丶丶丶
禔	礻日丨ㄋ一一
示	示一一丶丶
手	手ノ一丨丨
殳	殳ノㄋ丶丶
疋	疋ㄋ丨丶丶
旧	丨日丨ㄋ一一
兕	凹儿ノㄋㄋㄋ
凹	凹丨ㄋ一一
凸	凸丨一一一
芈	丨一丨一丨丨
惬	忄匚一丶丶丶
怄	忄区一ノㄋㄋ
慨	忄一ㄋㄋㄋ
恸	忄云ㄋノノノ
愀	忄禾丶ノ丶丶
懈	忄角ㄋノ丨丨
懒	忄束ノㄋ丶丶
恂	忄勹丨ㄋ一一
怵	忄木丶丶丶丶
恻	忄贝丨丨丨丨
悯	忄门丶一丶丶
恫	忄冂丨ㄋ一一
悃	忄囗一丨丶丶
恹	忄厂一ノ丶丶
慵	忄广ㄋ一一一
惦	忄广丨一一一
慷	忄广ㄋ一丶丶
恢	忄丶ノ丶丶
怖	忄丨ㄋ丨丨
怩	忄尸ノㄋㄋㄋ
惨	忄叁ノノノノ
惯	忄毌丨ㄋ丶丶
愦	忄贵丨ㄋ丶丶
惧	忄ノ丶丶丶
悭	忄坚一丨一一
憷	忄林ㄋ丨丶丶
惚	忄勿丶ㄋ丶丶
憾	忄咸丶ㄋ丶丶
惰	忄一丨一一
懔	忄亠丨ㄋ丶丶
惊	忄京丶一丶丶
恍	忄光丨丶ㄋㄋ
懵	忄萝丶ㄋ一一
怜	忄令ノ丶丶丶
惋	忄宀ノㄋㄋㄋ
忙	忄亡丶一ㄋㄋ
懊	忄向丶ノ丶丶
愤	忄十一丨丶丶
悖	忄孛ㄋ丨一一
悔	忄每ノ一丶丶
愎	忄复ノ一丶丶
忤	忄一丨丨丨
忾	忄气ノ一ㄋㄋ
悄	忄肖丨丶一一
惝	忄尚丨丶一一
情	忄青一一一一
忪	忄公ノ丶丶丶
惮	忄单丶ノ丨丨
悦	忄总ノㄋㄋㄋ
憎	忄曾丶ノ一一
惶	忄白一一一一
慌	忄艹丶一ㄋㄋ
懂	忄艹ノ一一一
怊	忄召ㄋノ一一
忭	忄丶一丨丶丶
慑	忄耳ㄋ丶丶丶
悸	忄禾ㄋ丨一一
悒	忄口ㄋ丨ㄋㄋ
憧	忄立丨ㄋ一一
恤	忄丿丨ㄋ一一
恽	忄冖一ㄋ丨丨
惕	忄日ノㄋノノ
憬	忄日丶一丶丶
悍	忄日一一丨丨
惺	忄日ノ一一一
怛	忄旦丨ㄋ一一
恺	忄山ㄋ一ㄋㄋ
慎	忄直ノ丶丶丶
悴	忄卒丶一丨丨
忮	忄十ㄋ丶丶丶
悛	忄夋ㄋ丶丶丶
怡	忄台ㄋ丶一一
愣	忄罒丶一ノノ
悝	忄里丨ㄋ一一
悻	忄土丶ノ丨丨
恃	忄土一丨丶丶
怯	忄去一丨丶丶
怆	忄仓ノ丶ㄋㄋ
恒	忄一丨ㄋ一一
怔	忄正一丨一一
怿	忄又一一丨丨
怪	忄又一丨一一
愠	忄日丨ㄋ一一
慢	忄日丨ㄋ丶丶
恪	忄各ノㄋ一一
憔	忄隹丶丶丶丶
惜	忄昔一丨一一
怕	忄白ノ丨一一
惭	忄车ノノ丨丨
忸	忄丑ㄋ丨一一
忖	忄寸一丨丶丶
忉	忄刀ㄋノノノ
悌	忄弟丶ノノノ
怫	忄弓ノ丨丨丨
愧	忄鬼ノ丨丶丶
忻	忄斤ノノ丨丨
快	忄夬ㄋ一丶丶
怦	忄平一丶丨丨
忏	忄千ノ一丨丨
性	忄生ノ一一一
悚	忄束一丨丶丶
怃	忄一一ノㄋㄋ
怏	忄央丨ㄋ丶丶
忆	忄乙ㄋㄋㄋㄋ
忱	忄冖ノㄋㄋㄋ
忧	忄尢丶丶丶丶
怍	忄乍ノ一一一
怅	忄长ノ一丶丶
忡	忄中丨ㄋ丨丨
惟	忄隹ノ丨一一
惘	忄冂丶ノㄋㄋ
惆	忄冂一丨一一
恼	忄㐫丶一丨丨
愉	忄俞ノ丶丨丨
恰	忄合ノ丶一一
悼	忄卓丨一丨丨
恬	忄舌ノ一一一
惴	忄山一ノ丨丨
怙	忄古一丨一一
悟	忄五丨ㄋ一一
愕	忄吅一一ㄋㄋ
懦	忄雨一ノ丨丨
愫	忄ㄋㄋ丶丶
慊	忄兼丶ノ丶丶
怀	忄不一ノ丶丶
悱	忄非丨一一一
恨	忄艮ㄋ一丶丶
㥄	忄土ノ丶丶丶
忳	忄屯一ㄋㄋㄋ
憭	忄尞一ノ丶丶
憺	忄厃ノ丶一一
赖	束丨ㄋ丶丶
剌	束刂丨丨丨丨
敕	束攵ノ一丶丶
速	束辶丶ㄋ丶丶
整	束攵一丨一一
束	束一丨丶丶
双	双ㄋ丶丶丶
凼	水凵ㄋ丨丨丨
水	水丨ㄋ丶丶
淼	水水丨ㄋ丶丶
沓	水日丨ㄋ一一
逡	夋辶丶ㄋ丶丶
迨	台辶丶ㄋ丶丶
叁	叁三一一一一
参	叁彡ノノノノ
熊	厶⺝ノㄋ丶丶
垒	厶厶ㄋ丶一一
炱	台火丶ノ丶丶
怠	台心丶ㄋ丶丶
毵	叁彡ノ一ㄋㄋ
能	厶⺝ノㄋㄋㄋ
邰	台阝ㄋ丨丨丨
皴	夋皮ㄋノ丶丶
畚	叁田丨ㄋ一一
允	厶儿ノㄋㄋㄋ
弁	厶廾一ノ丨丨
台	台ㄋ丶一一
牟	厶牛ノ一丨丨
矣	厶矢ノ一丶丶
巽	巳巳一丨丶丶
巳	巳ㄋ一ㄋㄋ
导	巳寸一丨丶丶
异	巳廾一ノ丨丨
逻	罒夕丶ㄋ丶丶
罢	罒去一丨丶丶
罴	罒去丶丶丶丶
罡	罒正一丨一一
罗	罒夕ノㄋ丶丶
詈	罒言丶一一一
羁	罒革ㄋㄋ一一
罹	罒忄ノ丨一一
罚	罒讠丨丨丨丨
蜀	罒勹丨ㄋ丶丶
署	罒者一丨一一
罾	罒曾丶ノ一一
罩	罒卓丨一丨丨
罨	罒大丨ㄋㄋㄋ
置	罒直一丨一一
罱	罒十丨ㄋ丨丨
罟	罒古一丨一一
罘	罒不一ノ丶丶
罪	罒非丨一一一
鹮	罒同ノㄋ一一
罽	罒厂丶ノ丨丨
罶	罒留丨ㄋ一一
翾	罒同ノㄋ一一
拣	扌练一ㄋ丶丶
揠	扌匚丨ㄋ一一
拒	扌匚ㄋ一一一
抠	扌区一ノㄋㄋ
搦	扌弓丶一一一
撕	扌其ノノ丨丨
撤	扌丨ㄋ丶丶
撒	扌丨ㄋ丶丶
擀	扌ノ丶丨丨
捌	扌另丨丨丨丨
擞	扌米ㄋノ丶丶
撷	扌吉一ノ丶丶
撖	扌敢ノ一丶丶
抑	扌ㄋ丨丨丨
批	扌比一ㄋㄋㄋ
挪	扌ㄋ丨丨丨
拊	扌付ノ丨丶丶
揶	扌耳ㄋ丨丨丨
揪	扌禾丶ノ丶丶
掀	折欠ノㄋ丶丶
搠	扌屰ノㄋ一一
拗	扌幺ㄋノノノ
搬	扌舟ノㄋ丶丶
扬	扌汤ㄋノノノ
捣	扌丨ㄋ丨丨
掏	扌勹ノ一丨丨
拘	扌句ノㄋ一一
掬	扌勹丶ノ丶丶
抱	扌勹ㄋ一ㄋㄋ
拭	扌弋一丨一一
抛	扌九ㄋノノノ
挺	扌壬ㄋ丶丶丶
挝	扌寸丶ㄋ丶丶
挞	扌大丶ㄋ丶丶
搞	扌高丶一一一
搁	扌门ノㄋ一一
捆	扌囗一丨丶丶
掴	扌囗一一丶丶
拨	扌发ㄋノ丶丶
搋	扌丨一ㄋㄋ
掳	扌虍ㄋノノノ
摅	扌虍丶ㄋ丶丶
搓	扌一丨一一
撅	扌厂丶ノ丶丶
振	扌辰一ノ丶丶
扼	扌厂ㄋㄋㄋㄋ
掂	扌广丨一一一
摭	扌度丶丶丶丶
搪	扌广ㄋ一一一
掮	扌户丨ㄋ一一
捩	扌户一ノ丶丶
握	扌尸一ㄋ一一
搌	扌尸一丨丶丶
摒	扌尸丶ノ丨丨
抿	扌民ㄋ一ㄋㄋ
掘	扌尸ㄋ丨丨丨
捃	扌尹丨ㄋ一一
扳	扌ㄋ丶丶丶
掺	扌叁ノノノノ
掼	扌毌丨ㄋ丶丶
挠	扌尧一ㄋㄋㄋ
撄	扌贝丨ㄋ一一
攒	扌先ノ一丶丶
揩	扌比ノ丨一一
撵	扌夫一一丨丨
撰	扌巳ㄋ一丶丶
擢	扌羽ノ丨一一
掇	扌双ㄋ丶丶丶
撼	扌咸丶ㄋ丶丶
摁	扌因丶ㄋ丶丶
搔	扌又丶丨丶丶
攫	扌目丨ㄋ丶丶
捻	扌今丶ㄋ丶丶
撺	扌穴丨ㄋ丨丨
控	扌穴一丨一一
擅	扌亠丨ㄋ一一
掠	扌京丶一丶丶
搐	扌玄丨ㄋ一一
搀	扌免丶丶丶丶
撸	扌鱼丨ㄋ一一
拎	扌令ノ丶丶丶
挖	扌穴ㄋㄋㄋㄋ
擦	扌宀ノㄋ丶丶
摈	扌宀ノ丨丶丶
按	扌宀ㄋノ一一
掖	扌夜丶一丶丶
抗	扌亠ノㄋㄋㄋ
播	扌番ノ丶一一
掭	扌天丨丶丶丶
搡	扌又ㄋ丶丶丶
撩	扌尞一ノ丶丶
授	扌受ㄋ丶丶丶
拖	扌ㄋ丨ㄋㄋ
挽	扌免ノㄋㄋㄋ
掐	扌ノ丨一一
换	扌丨ㄋ丶丶
捎	扌肖丨丶一一
挡	扌ㄋ一一一
揍	扌ノ一丶丶
捧	扌一一丨丨
扮	扌分ノ丶ノノ
掸	扌单丶ノ丨丨
掷	扌䒑一ノ丨丨
拼	扌䒑一ノ丨丨
拦	扌兰丶ノ一一
抡	扌人ノㄋㄋㄋ
指	扌旨ノㄋ一一
拈	扌占丨一一一
摸	扌莫一丨丶丶
搽	扌艹ノ丶丶丶
捞	扌劳ㄋノノノ
描	扌艹丨ㄋ一一
掩	扌大丨ㄋㄋㄋ
捺	扌大一一丶丶
招	扌召ㄋノ一一
拄	扌主丶一一一
摄	扌耳ㄋ丶丶丶
搏	扌甫一丨丶丶
投	扌殳ノㄋ丶丶
捐	扌口丨ㄋ一一
损	扌口丨ㄋ丶丶
挹	扌口ㄋ丨ㄋㄋ
揖	扌口一丨一一
拐	扌另丨ㄋノノ
捉	扌足丨ㄋ丶丶
撞	扌立丨ㄋ一一
掊	扌立丨ㄋ一一
接	扌立ㄋノ一一
撬	扌毛ノ一ㄋㄋ
揉	扌矛一丨丶丶
搂	扌米ㄋノ一一
揸	扌木丨ㄋ一一
探	扌冖ノ丶丶丶
挥	扌冖一ㄋ丨丨
撮	扌日一丨丶丶
提	扌是丨ㄋ丶丶
捍	扌日一一丨丨
担	扌旦丨ㄋ一一
摧	扌山ノ丨一一
技	扌十ㄋ丶丶丶
拮	扌吉一丨一一
抵	扌氏丶丶丶丶
抬	扌台ㄋ丶一一
挨	扌厶ノ一丶丶
摆	扌罒一丨丶丶
撂	扌田ノㄋ一一
持	扌土一丨丶丶
挂	扌圭一丨一一
拴	扌人一一一一
挤	扌文ノ丨丨丨
抢	扌仓ノ丶ㄋㄋ
抄	扌小ノノノノ
搜	扌臼丨ㄋ丶丶
择	扌又一一丨丨
擂	扌雨丨ㄋ一一
攉	扌雨ノ丨一一
揭	扌曷丨ㄋㄋㄋ
捏	扌日一丨一一
捋	扌爫一丨丶丶
摇	扌爫ノ一丨丨
援	扌爰ノ丶丶丶
拯	扌丞ㄋ丨一一
携	扌隹ㄋノノノ
擤	扌自丨ㄋ丨丨
捅	扌甬ㄋ丶丨丨
拱	扌共一丨丶丶
措	扌昔一丨一一
报	扌卩ㄋ丶丶丶
拶	扌巛ノㄋ丶丶
扒	扌八ノ丶丶丶
把	扌巴ㄋ丨ㄋㄋ
拔	扌ㄋ丶丶丶
拍	扌白ノ丨一一
扑	扌卜丨丶丶丶
插	扌千ノ丨一一
拆	折丶丶丶丶丶
扭	扌丑ㄋ丨一一
拙	扌出ㄋ丨丨丨
捶	扌垂ノ一一一
抖	扌⺀一丨丨丨
扶	扌夫一一丶丶
拂	扌弓ノ丨丨丨
捕	扌甫一丨丶丶
找	扌戈一ㄋ丶丶
扛	扌工一丨一一
扩	扌广丶一ノノ
护	扌户丶ㄋノノ
扫	扌彐ㄋ一一一
挟	扌夹ノ丶丶丶
押	扌甲丨ㄋ丨丨
捷	扌妻一ノ丶丶
折	折一丨丨丨
揿	扌钅ノㄋ丶丶
抉	扌夬ㄋ一丶丶
扣	扌口丨ㄋ一一
拉	扌立丶一一一
拢	扌龙一ノ丶丶
摔	扌玄丶一丨丨
扪	扌门丶丨ㄋㄋ
抹	扌未一一丶丶
拇	扌母ㄋㄋ丶丶
扔	扌乃ㄋノノノ
披	扌皮ㄋノ丶丶
抨	扌平一丶丨丨
扦	扌千ノ一丨丨
抻	扌日丨丨丨丨
拓	扌石一ノ一一
托	扌乇ノ一ㄋㄋ
执	执一丨丶丶
抚	扌一一ノㄋㄋ
拽	扌曳丨ㄋノノ
扎	扌乚ㄋㄋㄋㄋ
拟	扌以ㄋ丶丶丶
拥	扌用ノㄋ丨丨
扰	扌尢丶丶丶丶
摊	扌又ノ丨一一
抓	扌爪ノノ丶丶
挑	扌儿丶一丶丶
扯	扌止丨一一一
抟	扌专一一丶丶
推	扌隹ノ丨一一
挫	扌从一丨一一
逝	折辶丶ㄋ丶丶
踅	折足丨ㄋ丶丶
蜇	折虫丨ㄋ丶丶
哲	折口丨ㄋ一一
誓	折言丶一一一
鸷	扌执ノㄋ一一
贽	执贝丨ㄋ丶丶
蛰	执虫丨ㄋ丶丶
热	执灬丶丶丶丶
势	执力ㄋノノノ
挚	执手ノ一丨丨
垫	执土一丨一一
拚	扌厶一ノ丨丨
捱	扌厂一丨一一
摺	扌羽ノ丨一一
揞	扌立丨ㄋ一一
挢	扌夭ノ丨丨丨
擗	扌辟ㄋ一丨丨
揎	扌㝉丨ㄋ一一
揲	扌世一丨丶丶
挣	扌争ノㄋ丨丨
撇	扌敝丶ノ丶丶
据	扌尸一丨一一
捭	扌卑ノ丨丨丨
拷	扌耂一ㄋㄋㄋ
攮	扌橐丨ㄋ丶丶
揽	扌监丨ㄋㄋㄋ
摘	扌啇丶一一一
搅	扌学丨ㄋㄋㄋ
撑	扌ノ一丨丨
攥	扌丨ㄋ丶丶
撙	扌酋一丨丶丶
拧	扌宀一丨丨丨
攘	扌襄丶一丶丶
操	扌口丨ㄋ丶丶
揄	扌俞ノ丶丨丨
捡	扌佥ノ丶一一
拾	扌合ノ丶一一
揆	扌癸ㄋ丶丶丶
掉	扌卓丨一丨丨
搭	扌艹ノ丶一一
掎	扌大一丨丨丨
挎	扌大一一ㄋㄋ
掾	扌彖ㄋㄋ丶丶
括	扌舌ノ一一一
揣	扌山一ノ丨丨
摞	扌田ㄋㄋ丶丶
捂	扌五丨ㄋ一一
搛	扌兼丶ノ丶丶
拌	扌半丶ノ丨丨
打	扌丁一丨丨丨
排	扌非丨一一一
抽	扌由丨ㄋ一一
抒	扌予ㄋ丶丨丨
絷	执糸ㄋㄋ丶丶
扺	扌氏ノㄋㄋㄋ
扽	扌屯一ㄋㄋㄋ
拃	扌乍ノ一一一
捽	扌卒丶一丨丨
揳	扌丰ㄋノ丶丶
搒	扌帝丶一ノノ
摛	扌㐫丨ㄋ丶丶
毗	田比一ㄋㄋㄋ
畴	田一丨丶丶
畈	田ㄋ丶丶丶
畹	田宀ノㄋㄋㄋ
疃	田立丨ㄋ一一
畛	田㐱ノ丶ノノ
畦	田圭一丨一一
略	田各ノㄋ一一
畋	田攵ノ一丶丶
畎	田犬一ノ丶丶
胃	田⺝丨ㄋ一一
界	田人ノ丨丨丨
畀	畀丨ㄋ丨丨
男	田力ㄋノノノ
思	田心丶ㄋ丶丶
畏	田一ㄋノ丶丶
田	田丨ㄋ一一
嬲	田力ㄋノノノ
畸	田大一丨丨丨
畔	田半丶ノ丨丨
町	田丁一丨丨丨
累	田糸ㄋㄋ丶丶
罍	田田丨ㄋ丨丨
疁	田羽ノ丶ノノ
迥	冂口丶ㄋ丶丶
冈	冈丨ㄋ丶丶
典	曲八ノ丶丶丶
央	央丨ㄋ丶丶
肉	内人ノ丶丶丶
册	冂冂一一一一
丹	丹ノㄋ一一
冉	冉丨ㄋ一一
雕	冂吉ノ丨一一
刚	冈刂丨丨丨丨
网	冂乂ノ丶丶丶
罔	冂䒑丶一ㄋㄋ
周	冂吉一丨一一
同	冂同丨ㄋ一一
逼	同田丶ㄋ丶丶
副	同田丨丨丨丨
翮	鬲羽ㄋ丶一一
融	鬲虫丨ㄋ丶丶
鬷	鬲㐅ㄋ丨丶丶
鹝	鬲鸟ノㄋ一一
逵	土八一丨丶丶
盐	土卜丨ㄋ一一
袁	土口ノㄋ丶丶
恚	圭心丶ㄋ丶丶
幸	土丶ノ丨丨
寺	土寸一丨丶丶
圭	圭一丨一一
土	土一丨一一
垅	土龙一ノ丶丶
堀	土尸ㄋ丨丨丨
坶	土母ㄋㄋ丶丶
赭	赤者一丨一一
赫	赤赤一丨丶丶
赧	赤卩ㄋ丶丶丶
赦	赤攵ノ一丶丶
郝	赤阝ㄋ丨丨丨
卦	圭卜丨丶丶丶
封	圭寸一丨丶丶
堍	土免丶丶丶丶
堰	土匚丨ㄋ一一
墩	土享ノ一丶丶
堠	土亻ノ丨丶丶
埘	土日一丨丶丶
坳	土幺ㄋノノノ
堋	土月ノㄋ一一
场	土汤ㄋノノノ
坷	土可一丨丨丨
均	土勹丶一一一
域	土戈丨ㄋ一一
埏	土丿丨一丶丶
垧	土向丨ㄋ一一
坝	土贝丨ㄋ丶丶
垌	土冂丨ㄋ一一
城	土戊ㄋㄋㄋㄋ
墟	土虍丨丨一一
垢	土丨ㄋ一一
塬	土厂ノ丨丶丶
坜	土厂ㄋノノノ
墉	土广ㄋ一一一
塘	土广ㄋ一一一
墀	土尸丨丶丨丨
坭	土尸ノㄋㄋㄋ
坂	土ㄋ丶丶丶
埤	土卑ノ丨丨丨
坎	土欠ノㄋ丶丶
堵	土者一丨一一
墙	土十丶ノ一一
垤	土至一ㄋ一一
墚	土氵ㄋノ丶丶
堪	土其ㄋㄋㄋㄋ
埝	土今丶ㄋ丶丶
墒	土啇丶一一一
壕	土亮一ノ丶丶
垸	土宀一一ㄋㄋ
坨	土宀ノㄋㄋㄋ
垓	土亥丶一丶丶
垴	土㐫丶一丨丨
壤	土襄丶一丶丶
坑	土亠ノㄋㄋㄋ
境	土音ノㄋㄋㄋ
圪	土ㄋㄋㄋㄋ
增	土曾丶ノ一一
垆	土⺊ㄋ一ノノ
坫	土占丨一一一
坯	土不一一一一
塔	土艹ノ丶一一
垮	土大一一ㄋㄋ
埯	土大丨ㄋㄋㄋ
圬	土亏一一ㄋㄋ
坛	土云一一丶丶
垛	土几一丨丶丶
埽	土彐丶ㄋ丨丨
埙	土口丨ㄋ丶丶
埚	土呙丨ㄋ丶丶
埕	土口一一一一
培	土立丨ㄋ一一
埸	土日ノㄋノノ
堤	土是丨ㄋ丶丶
坦	土旦丨ㄋ一一
垲	土山ㄋ一ㄋㄋ
埴	土直一丨一一
填	土直ノ丶丶丶
坻	土氏丶丶丶丶
堞	土世一丨丶丶
埃	土厶ノ一丶丶
塄	土罒丶一ノノ
埋	土里丨ㄋ一一
堙	土覀一丨一一
垣	土一丨ㄋ一一
塌	土日ㄋ丶一一
墁	土日丨ㄋ丶丶
埒	土爫一丨丶丶
坏	土不一ノ丶丶
坼	土斤丶丶丶丶
圳	土川ノ丨丨丨
坍	土丹ノㄋ一一
坊	土方丶一ノノ
埔	土甫一丨丶丶
坩	土甘一丨一一
塥	土鬲一丨丨丨
垠	土艮ㄋ一丶丶
埂	土更一丨丶丶
圹	土广丶一ノノ
圾	土及ノㄋ丶丶
圮	土己ㄋ一ㄋㄋ
圻	土斤ノノ丨丨
块	土夬ㄋ一丶丶
垃	土立丶一一一
埭	土隶ㄋ一丶丶
坡	土皮ㄋノ丶丶
坪	土平一丶丨丨
坤	土日丨丨丨丨
圯	土巳ㄋ一ㄋㄋ
坟	土文丶一丶丶
坞	土乌ㄋ一一一
垭	土亚一丨一一
地	土也ㄋ丨ㄋㄋ
圩	土于一一丨丨
址	土止丨一一一
堆	土隹ノ丨一一
埠	土一丨丨丨
螫	赤攵丨ㄋ丶丶
赤	赤一丨丶丶
鋆	土勹丶一一一
邽	圭阝ㄋ丨丨丨
邿	土寸ㄋ丨丨丨
赪	赤⺊丨ㄋ丶丶
顿	屯页一ノ丶丶
屯	屯一ㄋㄋㄋ
邨	屯阝ㄋ丨丨丨
瓦	瓦一ㄋ丶丶
望	亡月一一一一
肓	亡⺝丨ㄋ一一
赢	赢贝丨ㄋ丶丶
蠃	赢虫丨ㄋ丶丶
嬴	赢女ㄋノ一一
羸	赢羊丶ノ丨丨
盲	亡目丨ㄋ一一
妄	亡女ㄋノ一一
忘	亡心丶ㄋ丶丶
弃	廾一ノ丨丨
亡	亡丶一ㄋㄋ
育	⺝丨ㄋ一一
氓	亡民ㄋ一ㄋㄋ
邙	亡阝ㄋ丨丨丨
璐	王ノㄋ一一
玳	王亻一ㄋ丶丶
璇	王族ㄋ丨丶丶
珈	王加ㄋノ一一
琳	王林一丨丶丶
珠	王丿一一丶丶
琊	王牙ㄋ丨丨丨
琏	王车丶ㄋ丶丶
琥	王虍ノㄋㄋㄋ
瑭	王广ㄋ一一一
瑁	王日丨ㄋ一一
琪	王其一丨丶丶
璎	王贝丨ㄋ一一
瓒	王先ノ一丶丶
璨	王⺊ノㄋ丶丶
璁	王囟ノㄋ丶丶
琼	王京丶一丶丶
玲	王令ノ丶丶丶
琬	王宀ノㄋㄋㄋ
琮	王宀一一丶丶
瑷	王受一ノ丶丶
琐	王丨ㄋ丶丶
玢	王分ノ丶ノノ
玷	王占丨一一一
瑛	王艹丨ㄋ丶丶
琰	王炎丶ノ丶丶
瑾	王堇一丨一一
琛	王冖ノ丶丶丶
珲	王冖一ㄋ丨丨
琨	王日一ㄋㄋㄋ
珍	王㐱ノ丶ノノ
璀	王山ノ丨一一
理	王里丨ㄋ一一
珐	王去一丨丶丶
璞	王业丶ノ丶丶
玩	王元一一ㄋㄋ
瑶	王爫ノ一丨丨
瑗	王爰ノ丶丶丶
珞	王各ノㄋ一一
珙	王共一丨丶丶
班	王一一一一
珀	王白ノ丨一一
珊	王冂丨ㄋ一一
琢	王豕丶丶丶丶
珥	王耳一丨一一
玫	王攵ノ一丶丶
瑰	王鬼ノ丨丶丶
玑	王几ノㄋㄋㄋ
瑕	王叚ㄋ一丶丶
玖	王久ノㄋ丶丶
珑	王龙一ノ丶丶
玛	王马ㄋㄋ一一
珉	王民ㄋ一ㄋㄋ
玻	王皮ㄋノ丶丶
球	王求一丨丶丶
玮	王韦一一丨丨
玟	王文丶一丶丶
斑	王文一一一一
顼	王页一ノ丶丶
珏	王王丶丶丶丶
珧	王儿丶一丶丶
碧	王白一ノ一一
琵	王王一ㄋㄋㄋ
琴	王王ノ丶ㄋㄋ
琶	王王ㄋ丨ㄋㄋ
瑟	王王丶ㄋ丶丶
弄	王廾一ノ丨丨
王	王一一一一
玉	王丶丶丶丶丶
噩	王口丨ㄋ一一
瑚	王古ノㄋ一一
珩	王彳一一丨丨
珂	王可一丨丨丨
现	王见ノㄋㄋㄋ
璩	王虍一ノ丶丶
琚	王尸一丨一一
璃	王㐫丨ㄋ丶丶
瑜	王俞ノ丶丨丨
琉	王㐬丶一ㄋㄋ
琦	王大一丨丨丨
琅	王良丶ㄋ丶丶
璋	王音一丨丨丨
璜	王丨ㄋ丶丶
瑞	王山一ノ丨丨
环	王不一ノ丶丶
玎	王丁一丨丨丨
玚	王汤ㄋノノノ
玦	王夬ㄋ一丶丶
玱	王仓ノ丶ㄋㄋ
玹	王亠ㄋㄋ丶丶
玼	王此丨一ㄋㄋ
珌	王必丶ㄋ丶丶
珪	王圭一丨一一
珰	王ㄋ一一一
珷	王一一ㄋ一一
珸	王五丨ㄋ一一
珺	王尹丨ㄋ一一
琄	王口丨ㄋ一一
琭	王录ㄋ一丶丶
瑂	王丨ㄋ一一
瑅	王是丨ㄋ丶丶
瑔	王白丨ㄋ丶丶
瑝	王白一一一一
瑢	王宀ノ丶一一
瑨	王亚丨ㄋ一一
瑱	王直ノ丶丶丶
璆	王羽ノ丶ノノ
璠	王番ノ丶一一
璮	王亠丨ㄋ一一
璲	王㒸丶ㄋ丶丶
瓀	王雨一ノ丨丨
囫	囗勿ノㄋノノ
囹	囗令ノ丶丶丶
圊	囗青一一一一
圈	囗ㄋㄋㄋㄋ
囵	囗八ノㄋㄋㄋ
圆	囗口丨ㄋ丶丶
圉	囗土丶ノ丨丨
园	囗元一一ㄋㄋ
囿	囗丨ㄋ一一
图	囗夂丶丶丶丶
团	囗才一丨ノノ
因	因丨ㄋ一一
圃	囗甫一丨丶丶
困	囗木一丨丶丶
囡	囗女ㄋノ一一
囚	囗人ノ丶丶丶
囤	囗屯一ㄋㄋㄋ
围	囗韦一一丨丨
恩	因心丶ㄋ丶丶
囗	囗丨ㄋ一一
四	四丨ㄋ一一
曰	曰丨ㄋ一一
囝	囗子ㄋ丨一一
固	囗古一丨一一
圄	囗五丨ㄋ一一
国	囗王丶丶丶丶
圌	囗山一ノ丨丨
韧	韦刀丶丶丶丶
韫	韦日丨ㄋ一一
韬	韦爫ノ丨一一
违	韦辶丶ㄋ丶丶
韦	韦一一丨丨
韨	韦ㄋ丶丶丶
嫠	未攵一ノ一一
釐	未攵一ノ一一
迹	亦辶丶ㄋ丶丶
壅	亠乡ノ丨一一
禀	亠回一一丶丶
奕	亦大一ノ丶丶
弈	亦廾一ノ丨丨
畜	玄田丨ㄋ一一
夜	夜丶一丶丶
亵	亠执ノㄋ丶丶
雍	亠乡ノ丨一一
充	儿ノㄋㄋㄋ
亦	亦丶一丶丶
#衰	哀一ノㄋ丶丶
褒	亠华丨ㄋ丶丶
裹	亠日一丨丶丶
裒	亠臼ノㄋ丶丶
#哀	哀ノㄋ丶丶
袤	亠矛ノㄋ丶丶
#衷	亠中ノㄋ丶丶
亢	亠几ノㄋㄋㄋ
市	亠巾丨ㄋ丨丨
亩	亠田丨ㄋ一一
玄	玄丶一丶丶
率	玄一丨丨丨
颤	亠回丨ㄋ丶丶
瓤	襄瓜ノノ丶丶
颃	亠几一ノ丶丶
饔	亠乡ノ丨丶丶
襄	襄丶一丶丶
卞	丶下一丨丶丶
鹯	亠回丨ㄋ一一
斌	文一一ㄋ一一
斓	文门一丨丶丶
刘	文刂丨丨丨丨
这	文辶丶ㄋ丶丶
齑	文丨一一一
齐	文ノ丨丨丨
吝	文口丨ㄋ一一
文	文丶一丶丶
剂	文丨丨丨丨
离	㐫禸丨ㄋ丶丶
紊	文糸ㄋㄋ丶丶
斋	文而一ノ丨丨
赟	文一一ㄋ丶丶
鹅	我鸟ノㄋ一一
我	我ノ一丶丶
毋	毋ㄋㄋ一一
吾	五口丨ㄋ一一
郚	五口ㄋ丨丨丨
敔	五口ノ一丶丶
鬯	㐅灬ㄋ丨ㄋㄋ
五	五一丨一一
虺	兀虫丨ㄋ丶丶
臧	戊爿一丨ㄋㄋ
威	戊一ㄋノ一一
蹙	戊上丨ノ丶丶
盛	戊丨ㄋ一一
感	咸心丶ㄋ丶丶
戊	戊一ノ丶丶
戚	戊上丨ノ丶丶
成	戊ㄋㄋㄋㄋ
戍	戊丶丶丶丶丶
戌	戊一一一一一
咸	咸一ノ丶丶
觱	咸角ノㄋ丨丨
外	夕卜丨丶丶丶
舛	舛ノㄋ丨丨
鸳	夗鸟ノㄋ一一
眢	夗目丨ㄋ一一
怨	夗心丶ㄋ丶丶
桀	舛木一丨丶丶
名	夕口丨ㄋ一一
多	夕夕ノㄋ丶丶
夕	夕ノㄋ丶丶
飧	夕食ノ丶丶丶
夤	夕㝉丨ㄋ丶丶
覆	覀彳ノ一丶丶
贾	覀贝丨ㄋ丶丶
粟	覀米丶ノ丶丶
栗	覀木一丨丶丶
要	覀女ㄋノ一一
票	覀示一一丶丶
飘	覀示ノㄋ丶丶
剽	覀示丨丨丨丨
瓢	覀示ノノ丶丶
甄	覀土一ㄋ丶丶
鄄	覀土ㄋ丨丨丨
覃	覀早丨ㄋ丨丨
歅	覀土ノㄋ丶丶
迺	西辶丶ㄋ丶丶
习	习ㄋ丶一一
飨	乡食ノ丶丶丶
逍	肖辶丶ㄋ丶丶
肖	肖丨丶一一
削	肖刂丨丨丨丨
尘	小土一丨一一
尜	小大丨ノ丶丶
劣	小丿ㄋノノノ
省	小丿丨ㄋ一一
尖	小大一ノ丶丶
少	小丿ノノノノ
小	小丨ノ丶丶
雀	小隹ノ丨一一
心	心丶ㄋ丶丶
必	必丶ㄋ丶丶
邲	必阝ㄋ丨丨丨
辛	辛丶一丨丨
鹗	吅亏ノㄋ一一
颚	吅亏一ノ丶丶
鄂	吅亏ㄋ丨丨丨
鼍	吅田一ㄋㄋㄋ
器	吅犬丨ㄋ一一
咒	吅几ノㄋㄋㄋ
骂	吅马ㄋㄋ一一
哭	吅犬一ノ丶丶
嚣	吅页丨ㄋ一一
嚚	吅臣丨ㄋ一一
窃	穴七ㄋノノノ
窈	穴幺ㄋノノノ
窿	穴阝ノㄋ一一
窗	穴囟ノㄋ丶丶
窟	穴尸ㄋ丨丨丨
窘	穴尹丨ㄋ一一
窒	穴至一ㄋ一一
窝	穴呙丨ㄋ丶丶
窨	穴音丶一一一
窦	穴十ㄋ丶丶丶
窜	穴口丨ㄋ丨丨
窑	穴缶ノ一丨丨
空	穴工一丨一一
穹	穴弓ㄋ一ㄋㄋ
窠	穴日一丨丶丶
帘	穴巾丨ㄋ丨丨
究	穴九ノㄋㄋㄋ
穷	穴力ㄋノノノ
窭	穴米ㄋノ一一
突	穴犬一ノ丶丶
窀	穴屯一ㄋㄋㄋ
穸	穴夕ノㄋ丶丶
穿	穴牙一ㄋノノ
窄	穴乍ノ一一一
窕	穴儿丶一丶丶
容	宀谷ノ丶一一
穴	穴丶丶丶丶
窆	穴丿丶ㄋ丶丶
邃	穴㒸丶ㄋ丶丶
窥	穴夫丨ㄋㄋㄋ
窍	穴工一ㄋㄋㄋ
窳	穴瓜ノノ丶丶
窬	穴俞ノ丶丨丨
窖	穴告ノ一一一
窣	穴卒丶一丨丨
窸	穴丿丶ノ丶丶
窊	穴瓜ノノ丶丶
窅	穴目丨ㄋ一一
窎	穴鸟ノㄋ一一
彟	彐寸一丨丶丶
鸦	牙鸟ノㄋ一一
雅	牙隹ノ丨一一
邪	牙阝ㄋ丨丨丨
迓	牙辶丶ㄋ丶丶
牙	牙一ㄋノノ
讵	讠匚ㄋ一一一
诓	讠匚一一一一
讴	讠区一ノㄋㄋ
讹	讠亻ノㄋㄋㄋ
诹	讠耳ㄋ丶丶丶
诳	讠犭一一一一
诛	讠丿一一丶丶
谢	讠身一丨丶丶
诩	讠羽ㄋ丶一一
词	讠一丨一一
询	讠勹丨ㄋ一一
诫	讠戈一ノ丨丨
谶	讠从一ㄋ一一
试	讠弋一丨一一
诞	讠丿丨一丶丶
谴	讠中一丶丶丶
谜	讠米丶ㄋ丶丶
谰	讠门一丨丶丶
诚	讠戊ㄋㄋㄋㄋ
讽	讠风ノㄋ丶丶
诡	讠厃ㄋㄋㄋㄋ
谑	讠虍一ㄋ一一
诟	讠丨ㄋ一一
谝	讠户丨ㄋ丨丨
诙	讠丶ノ丶丶
议	讠丶ノ丶丶丶
诸	讠者一丨一一
谐	讠比ノ丨一一
谮	讠旡一ㄋ一一
谬	讠羽ノ丶ノノ
谌	讠其ㄋㄋㄋㄋ
谛	讠帝丨ㄋ丨丨
谂	讠今丶ㄋ丶丶
谤	讠帝丶一ノノ
谅	讠京丶一丶丶
谆	讠享丶一一一
谗	讠免丶丶丶丶
谊	讠宀丨ㄋ一一
诧	讠宀ノ一ㄋㄋ
该	讠亥丶一丶丶
谫	讠前ㄋノノノ
谥	讠䒑ノ丶一一
诲	讠每ノ一丶丶
许	讠一丨丨丨
讫	讠ㄋㄋㄋㄋ
诌	讠刍ノㄋ一一
谄	讠ノ丨一一
诮	讠肖丨丶一一
请	讠青一一一一
诜	讠先ノ一ㄋㄋ
讼	讠公ノ丶丶丶
说	讠总ノㄋㄋㄋ
论	讠人ノㄋㄋㄋ
诣	讠旨ノㄋ一一
诺	讠艹一ノ一一
谎	讠艹丶一ㄋㄋ
谟	讠莫一丨丶丶
诏	讠召ㄋノ一一
谋	讠甘一丨丶丶
诱	讠禾ㄋノノノ
诿	讠禾ㄋノ一一
谈	讠炎丶ノ丶丶
设	讠殳ノㄋ丶丶
识	讠口ノ丶丶丶
误	讠口一一丶丶
谙	讠音丶一一一
谲	讠矛丨ㄋ一一
谨	讠堇一丨一一
诨	讠冖一ㄋ丨丨
诊	讠㐱ノ丶ノノ
谇	讠卒丶一丨丨
读	讠十ㄋ丶丶丶
诘	讠吉一丨一一
诋	讠氏丶丶丶丶
谍	讠世一丨丶丶
诒	讠台ㄋ丶一一
谡	讠田ノ丶丶丶
谓	讠田丨ㄋ一一
诗	讠土一丨丶丶
诖	讠圭一丨一一
诠	讠人一一一一
谚	讠产ノノノノ
证	讠正一丨一一
译	讠又一一丨丨
谒	讠曷丨ㄋㄋㄋ
谩	讠日丨ㄋ丶丶
谣	讠爫ノ一丨丨
谖	讠爰ノ丶丶丶
谯	讠隹丶丶丶丶
诵	讠甬ㄋ丶丨丨
谧	讠心ノ丨一一
讣	讠卜丨丶丶丶
诉	讠斤丶丶丶丶
诎	讠出ㄋ丨丨丨
诼	讠豕丶丶丶丶
训	讠川ノ丨丨丨
讨	讠寸一丨丶丶
访	讠方丶一ノノ
讦	讠干一一丨丨
讧	讠工一丨一一
课	讠日一丨丶丶
讥	讠几ノㄋㄋㄋ
记	讠己ㄋ一ㄋㄋ
讲	讠井一一丨丨
诀	讠夬ㄋ一丶丶
诔	讠耒一一丶丶
讷	讠内丨ㄋ丶丶
评	讠平一丶丨丨
诅	讠且丨ㄋ一一
认	讠人ノ丶丶丶
讪	讠山丨ㄋ丨丨
让	讠上丨一一一
计	讠十一丨丨丨
讳	讠韦一一丨丨
诬	讠工ノ丶丶丶
讯	讠一丨丨丨
讶	讠牙一ㄋノノ
详	讠羊丶ノ丨丨
谀	讠臼ノ丶丶丶
诈	讠乍ノ一一一
谁	讠隹ノ丨一一
谵	讠厃ノ丶一一
诶	讠厶ノ一丶丶
诤	讠争ノㄋ丨丨
谳	讠十丨ㄋ丨丨
诃	讠可一丨丨丨
调	讠冂一丨一一
谪	讠商丶一一一
谠	讠ノㄋㄋㄋ
谕	讠俞ノ丶丨丨
谱	讠並丨ㄋ一一
诰	讠告ノ一一一
话	讠舌ノ一一一
诂	讠古一丨一一
语	讠五丨ㄋ一一
谭	讠覀丨ㄋ丨丨
谔	讠吅一一ㄋㄋ
谦	讠兼丶ノ丶丶
订	讠丁一丨丨丨
诽	讠非丨一一一
诐	讠皮ㄋノ丶丶
讱	讠刀丶丶丶丶
诇	讠冂丨ㄋ一一
燮	言火丶ノ丶丶
言	言丶一一一
鸯	央鸟ノㄋ一一
盎	央皿丨ㄋ一一
善	羊䒑丨ㄋ一一
养	羊丶ノ丨丨丨
羊	羊丶ノ丨丨
鄯	羊䒑丨ㄋ丨丨
羚	羊令ノ丶丶丶
幻	幺ㄋㄋㄋㄋ
幼	幺力ㄋノノノ
畿	幺幺一ㄋ一一
幺	幺ㄋㄋ丶丶
乔	夭ノ丨丨丨
岙	夭山丨ㄋ丨丨
夭	夭ノ一丶丶
也	也ㄋ丨ㄋㄋ
邺	业阝ㄋ丨丨丨
凿	业ㄋ丨丨丨
黹	业丷丨ㄋ丶丶
业	业丨丨一一
黻	业米一ノ丶丶
黼	业丷丨ㄋ丶丶
页	页一ノ丶丶
救	求攵ノ一丶丶
劢	万力ㄋノノノ
武	一弋丨一一一
与	与一一一一一
遭	曹辶丶ㄋ丶丶
逦	丽辶丶ㄋ丶丶
逑	求辶丶ㄋ丶丶
迈	万辶丶ㄋ丶丶
曹	曹一丨一一
惠	惠心丶ㄋ丶丶
妻	妻女ㄋノ一一
型	开刂一丨一一
忝	天丨丶丶丶
蚕	天虫丨ㄋ丶丶
吞	天口丨ㄋ一一
焉	正与丶丶丶丶
虿	万虫丨ㄋ丶丶
忑	下心丶ㄋ丶丶
晋	亚日丨ㄋ一一
垩	亚土一丨一一
恶	亚心丶ㄋ丶丶
丽	丽一丨丶丶
画	一田ㄋ丨丨丨
亘	一旦丨ㄋ一一
天	天一一丶丶
开	开一一丨丨
灭	一火丶ノ丶丶
亓	一丌一ノ丨丨
再	一冉丨ㄋ一一
正	正一丨一一
一	一一一一一
于	于一一丨丨
下	下一丨丶丶
万	万一ㄋノノ
事	同肀ㄋ一丨丨
两	丙从ノ丶丶丶
西	西一丨一一
无	一尢一ノㄋㄋ
求	求一丨丶丶
更	更一丨丶丶
亚	亚一丨一一
严	亚丿ノノノノ
互	一彑ㄋㄋ一一
末	末一一丶丶
豆	豆一丨一一
丐	一⺊ㄋㄋㄋㄋ
吏	同乂ノ丶丶丶
兀	兀一ノㄋㄋ
卅	一川ノ丨丨丨
鬲	鬲一丨丨丨
鹉	一弋丨一一一
欤	与一ノㄋ丶丶
鄢	正与丶丶丨丨
戬	亚日丨ㄋ丶丶
鹂	丽鸟ノㄋ一一
郦	丽阝ㄋ丨丨丨
刑	开刂丨丨丨丨
形	开彡ノノノノ
邢	开阝ㄋ丨丨丨
邴	丙人ㄋ丨丨丨
政	正攵ノ一丶丶
迂	于辶丶ㄋ丶丶
裘	求衣丶一丶丶
趸	万足丨ㄋ丶丶
丙	丙人ノ丶丶丶
盂	于皿丨ㄋ一一
郪	妻女ㄋ丨丨丨
邘	于阝ㄋ丨丨丨
鄑	亚日ㄋ丨丨丨
祷	衤一丨丶丶
裼	衤日ノㄋノノ
褂	衤圭丨丶丶丶
褓	衤华丨ㄋ一一
袱	衤亻一ノ丶丶
襁	衤弓丨ㄋ丶丶
袍	衤勹ㄋ一ㄋㄋ
裢	衤车丶ㄋ丶丶
裥	衤门丨ㄋ一一
衩	衤又丶丶丶丶
褫	衤丨一ㄋㄋ
裤	衤广一ㄋ丨丨
褊	衤户丨ㄋ丨丨
裙	衤尹丨ㄋ一一
褚	衤者一丨一一
裕	衤谷ノ丶一一
褴	衤监丨ㄋ一一
褙	衤北丨ㄋ一一
褶	衤羽ノ丨一一
裰	衤双ㄋ丶丶丶
褥	衤辰一丨丶丶
襻	衤木ノ丶丨丨
衿	衤今ノ丶ㄋㄋ
裆	衤ㄋ一一一
裎	衤口一一一一
褛	衤米ㄋノ一一
衽	衤壬ノ一一一
袒	衤旦丨ㄋ一一
褐	衤曷丨ㄋㄋㄋ
袼	衤各ノㄋ一一
裱	衤ノㄋ丶丶
补	衤卜丨丶丶丶
衬	衤寸一丨丶丶
初	衤刀ㄋノノノ
裸	衤日一丨丶丶
袂	衤夬ㄋ一丶丶
袜	衤未一一丶丶
衲	衤内丨ㄋ丶丶
被	衤皮ㄋノ丶丶
衫	衤彡ノノノノ
褪	衤艮丶ㄋ丶丶
裾	衤尸一丨一一
裨	衤卑ノ丨丨丨
裣	衤佥ノ丶一一
袷	衤合ノ丶一一
褡	衤艹ノ丶一一
袄	衤夭ノ一丶丶
襦	衤雨一ノ丨丨
袢	衤半丶ノ丨丨
裉	衤艮ㄋ一丶丶
袖	衤由丨ㄋ一一
袪	衤去一丨丶丶
袆	衤韦一一丨丨
裈	衤冖一ㄋ丨丨
襕	衤门一丨丶丶
褯	衤广一丨丨丨
袗	衤㐱ノ丶ノノ
襚	衤㒸丶ㄋ丶丶
襜	衤厃ノ丶一一
褕	衤俞ノ丶丨丨
袯	衤发ㄋノ丶丶
裔	衣冏丨ㄋ一一
衣	衣丶一丶丶
颐	页一ノ丶丶
赜	丨ㄋ丶丶
乙	乙ㄋㄋㄋㄋ
厾	乙去一丨丶丶
已	已ㄋ一ㄋㄋ
刈	乂刂丨丨丨丨
凶	㐅凵ㄋ丨丨丨
希	希ノ丶丨丨
肴	乂丨ㄋ一一
杀	乂朩一丨丶丶
爻	爻ノ丶丶丶
欷	希欠ノㄋ丶丶
郄	乂ㄋ丶丨丨
郗	希阝ㄋ丨丨丨
弑	乂朩一ㄋ一一
刹	乂朩丨丨丨丨
瓻	希瓦一ㄋ丶丶
贰	弋二丨ㄋ丶丶
式	弋工一丨一一
忒	弋心丶ㄋ丶丶
鸢	弋鸟ノㄋ一一
甙	弋甘一丨一一
弋	弋一ㄋ丶丶
鸾	亦鸟ノㄋ一一
蛮	亦虫丨ㄋ丶丶
弯	亦弓ㄋ一ㄋㄋ
銮	亦金ノ丶一一
栾	亦木一丨丶丶
娈	亦女ㄋノ一一
脔	亦内ノ丶丶丶
峦	亦山丨ㄋ丨丨
挛	亦手ノ一丨丨
恋	亦心丶ㄋ丶丶
变	亦又ㄋ丶丶丶
孪	亦子ㄋ丨一一
竟	音儿ノㄋㄋㄋ
韵	音勹丶一一一
歆	音欠ノㄋ丶丶
韶	音召ㄋノ一一
意	音心丶ㄋ丶丶
音	音丶一一一
君	尹口丨ㄋ一一
尹	尹ㄋ一ノノ
群	尹口丶ノ丨丨
郡	尹口ㄋ丨丨丨
举	兴八一一丨丨
兴	兴八ノ丶丶丶
誉	兴八丶一一一
用	用ノㄋ丨丨
尥	尢勹丶丶丶丶
尴	尢监丨ㄋ一一
尬	尢人ノ丨丨丨
尤	尢丶丶丶丶丶
尢	尢一ノㄋㄋ
由	由丨ㄋ一一
邮	由阝ㄋ丨丨丨
迪	由辶丶ㄋ丶丶
胄	由⺝丨ㄋ一一
酬	酉川丶丶丶丶
酉	酉一丨一一
醣	酉广ㄋ一一一
醐	酉古ノㄋ一一
酌	酉勹丶丶丶丶
醚	酉米丶ㄋ丶丶
酞	酉大丶丶丶丶
酮	酉冂丨ㄋ一一
醵	酉虍一ノ丶丶
酗	酉乂ㄋ丨丨丨
酵	酉耂ㄋ丨一一
醪	酉羽ノ丶ノノ
醢	酉丨ㄋ一一
醇	酉享丶一一一
醯	酉㐬丨ㄋ一一
酡	酉宀ノㄋㄋㄋ
酴	酉余ノ丶丶丶
醑	酉疋丨ㄋ一一
酶	酉每ノ一丶丶
酰	酉先ノ一ㄋㄋ
酷	酉告ノ一一一
酚	酉分ノ丶ノノ
酯	酉旨ノㄋ一一
醛	酉艹ノ丶一一
酿	酉良丶ㄋ丶丶
酝	酉云一一丶丶
酲	酉口一一一一
醅	酉立丨ㄋ一一
醴	酉曲一丨一一
醌	酉日一ㄋㄋㄋ
醍	酉是丨ㄋ丶丶
醒	酉日ノ一一一
醉	酉卒丶一丨丨
酤	酉古一丨一一
酸	酉夋ㄋ丶丶丶
酩	酉夕丨ㄋ一一
醭	酉业丶ノ丶丶
酾	酉丽一丨丶丶
酹	酉爫一丨丶丶
酪	酉各ノㄋ一一
醮	酉隹丶丶丶丶
醋	酉昔一丨一一
酎	酉寸一丨丶丶
酊	酉丁一丨丨丨
酣	酉甘一丨一一
酐	酉干一一丨丨
酥	酉禾ノ一丶丶
配	酉己ㄋ一ㄋㄋ
醺	酉千丨ㄋ丶丶
酽	酉亚ノノノノ
酏	酉也ㄋ丨ㄋㄋ
酢	酉乍ノ一一一
酺	酉甫一丨丶丶
醨	酉㐫丨ㄋ丶丶
酦	酉发ㄋノ丶丶
鸡	又鸟ノㄋ一一
欢	又欠ノㄋ丶丶
对	又寸一丨丶丶
戏	又戈一ㄋ丶丶
劝	又力ㄋノノノ
难	又隹ノ丨一一
邓	又阝ㄋ丨丨丨
叉	又丶丶丶丶丶
怼	又寸丶ㄋ丶丶
蚤	又丶丨ㄋ丶丶
桑	又双一丨丶丶
叠	又双丶ㄋ一一
圣	又土一丨一一
又	又ㄋ丶丶丶
颡	又双一丨丶丶
观	又见丨ㄋㄋㄋ
艰	又艮ㄋ一丶丶
鲁	鱼日丨ㄋ一一
鱼	鱼ノㄋ一一
鲶	鱼今丶ㄋ丶丶
鳆	鱼丨ㄋ丶丶
鳋	鱼又丶丨丶丶
鲫	鱼ㄋ丨丨丨
鳓	鱼革ㄋノノノ
鲋	鱼付ノ丨丶丶
鲰	鱼耳ㄋ丶丶丶
鳅	鱼禾丶ノ丶丶
鲥	鱼日一丨丶丶
鲍	鱼勹ㄋ一ㄋㄋ
鲺	鱼ノ丨丶丶
鲢	鱼车丶ㄋ丶丶
鲷	鱼冂一丨一一
鲴	鱼囗一丨一一
鳜	鱼厂丶ノ丶丶
鳙	鱼广ㄋ一一一
鳊	鱼户丨ㄋ丨丨
鳍	鱼耂ノㄋ一一
鳝	鱼羊丶ノ一一
鲣	鱼坚一丨一一
鲸	鱼京丶一丶丶
鳟	鱼酋一丨丶丶
鲩	鱼宀一一ㄋㄋ
鲛	鱼交丶一丶丶
鲭	鱼青一一一一
鳇	鱼白一一一一
鲈	鱼⺊ㄋ一ノノ
鲇	鱼占丨一一一
鲻	鱼巛丨ㄋ一一
鲟	鱼彐一丨丶丶
鲵	鱼臼ノㄋㄋㄋ
鳞	鱼米ノㄋ丨丨
鲧	鱼丿ㄋㄋ丶丶
鳢	鱼曲一丨一一
鲲	鱼日一ㄋㄋㄋ
鲳	鱼日丨ㄋ一一
鲼	鱼十一丨丶丶
鲒	鱼吉一丨一一
鲽	鱼世一丨丶丶
鲐	鱼台ㄋ丶一一
鳏	鱼罒丨丶丶丶
鲤	鱼里丨ㄋ一一
鳃	鱼田丶ㄋ丶丶
鲮	鱼土ノ丶丶丶
鲑	鱼圭一丨一一
鲚	鱼文ノ丨丨丨
鳔	鱼覀一一丶丶
鳄	鱼吅一一ㄋㄋ
鲡	鱼丽一丨丶丶
鳕	鱼雨ㄋ一一一
鳎	鱼日ㄋ丶一一
鳗	鱼日丨ㄋ丶丶
鲔	鱼丨ㄋ一一
鳐	鱼爫ノ一丨丨
鲦	鱼夂一丨丶丶
鲅	鱼ㄋ丶丶丶
鲕	鱼而一ノ丨丨
鲂	鱼方丶一ノノ
鲱	鱼非丨一一一
鲠	鱼更一丨丶丶
稣	鱼禾ノ一丶丶
鲆	鱼平一丶丨丨
鲜	鱼羊丶ノ丨丨
鱿	鱼尢丶丶丶丶
鲀	鱼屯一ㄋㄋㄋ
鳚	鱼尸一一丶丶
鲃	鱼巴ㄋ丨ㄋㄋ
鳡	鱼咸丶ㄋ丶丶
鲌	鱼白ノ丨一一
鳑	鱼帝丶一ノノ
鲏	鱼皮ㄋノ丶丶
鳈	鱼白丨ㄋ丶丶
鲿	鱼丶ㄋ丶丶
鲉	鱼由丨ㄋ一一
鳀	鱼是丨ㄋ丶丶
鲙	鱼人一一丶丶
鳁	鱼日丨ㄋ一一
鳉	鱼丬ノㄋ丶丶
鳤	鱼丶丶一一
鲊	鱼乍ノ一一一
鱾	鱼己ㄋ一ㄋㄋ
鲯	鱼其一丨丶丶
鲪	鱼尹丨ㄋ一一
鲹	鱼叁ノノノノ
鳣	鱼亠丨ㄋ一一
鲗	鱼贝丨丨丨丨
鳒	鱼兼丶ノ丶丶
鳛	鱼羽ノ丨一一
鲾	鱼同丨ㄋ一一
鳠	鱼艹ノ丨丶丶
鱽	鱼刀ㄋノノノ
鲬	鱼甬ㄋ丶丨丨
鳂	鱼田一ㄋ丶丶
鲘	鱼丨ㄋ一一
觎	俞见丨ㄋㄋㄋ
毹	俞毛ノ一ㄋㄋ
逾	俞辶丶ㄋ丶丶
愈	俞心丶ㄋ丶丶
俞	俞ノ丶丨丨
鄃	俞阝ㄋ丨丨丨
予	予ㄋ丶丨丨
矛	矛ㄋ丶ノノ
鹜	矛攵ノㄋ一一
骛	矛攵ㄋㄋ一一
鹬	矛冏ノㄋ一一
矜	矛今ノ丶ㄋㄋ
豫	予象ノㄋ丶丶
预	予页一ノ丶丶
蝥	矛攵丨ㄋ丶丶
鍪	矛攵ノ丶一一
瞀	矛攵丨ㄋ一一
婺	矛攵ㄋノ一一
蟊	矛虫丨ㄋ丶丶
柔	矛木一丨丶丶
遹	矛冏丶ㄋ丶丶
矞	矛冏丨ㄋ一一
羽	羽ㄋ丶一一
翠	羽卒丶一丨丨
翼	羽田一丨丶丶
羿	羽廾一ノ丨丨
翌	羽立丶一一一
翟	羽隹ノ丨一一
鹨	羽㐱ノㄋ一一
戮	羽㐱一ㄋ丶丶
戳	羽隹一ㄋ丶丶
翀	羽中丨ㄋ丨丨
翂	羽分ノ丶ノノ
翯	羽高丶一一一
翚	羽冖一ㄋ丨丨
勠	羽㐱ㄋノノノ
霰	雨丨ㄋ丶丶
霹	雨辟ㄋ一丨丨
霖	雨林一丨丶丶
霜	雨相一丨一一
霪	雨氵ノ丶一一
霈	雨氵一丨丨丨
霭	雨讠丨ㄋㄋㄋ
霾	雨豸丨ㄋ一一
雹	雨勹ㄋ一ㄋㄋ
霆	雨壬ㄋ丶丶丶
震	雨辰一ノ丶丶
雳	雨厂ㄋノノノ
零	雨令ノ丶丶丶
霉	雨每ノ一丶丶
霄	雨肖丨丶一一
霓	雨臼ノㄋㄋㄋ
霎	雨立ㄋノ一一
霁	雨文ノ丨丨丨
雾	雨夂ㄋノノノ
雪	雨彐ㄋ一一一
霞	雨叚ㄋ一丶丶
雷	雨田丨ㄋ一一
雯	雨文丶一丶丶
霍	雨隹ノ丨一一
雨	雨一丨丶丶
酃	雨吅丨ㄋ丨丨
颥	雨而一ノ丶丶
露	雨ノㄋ一一
霸	雨革ノㄋ一一
雩	雨亏一一ㄋㄋ
需	雨而一ノ丨丨
霏	雨非丨一一一
雱	雨方丶一ノノ
霨	雨尸一一丶丶
霅	雨言丶一一一
鄠	雨亏ㄋ丨丨丨
鹴	雨相ノㄋ一一
建	聿廴ㄋ丶丶丶
聿	聿ㄋ一丨丨
远	元辶丶ㄋ丶丶
鼋	元口丨ㄋㄋㄋ
元	元一一ㄋㄋ
顽	元页一ノ丶丶
臌	月壴一丨丶丶
膨	月壴ノノノノ
脚	月去ㄋ丨丨丨
腻	月弋一一丶丶
肠	月汤ㄋノノノ
朐	月句ノㄋ一一
胞	月勹ㄋ一ㄋㄋ
腱	月聿ㄋ丶丶丶
肽	月大丶丶丶丶
胴	月冂丨ㄋ一一
胭	月因丨ㄋ一一
脆	月厃ㄋㄋㄋㄋ
肱	月ㄋ丶丶丶
腑	月广ノ丨丶丶
脏	月广一丨一一
脲	月尸丨ㄋ丶丶
腆	月曲ノ丶丶丶
肷	月欠ノㄋ丶丶
膳	月羊丶ノ一一
腔	月穴一丨一一
膻	月亠丨ㄋ一一
膀	月帝丶一ノノ
胱	月光丨丶ㄋㄋ
腕	月宀ノㄋㄋㄋ
膑	月宀ノ丨丶丶
脘	月宀一一ㄋㄋ
腚	月定丶丶丶丶
胺	月宀ㄋノ一一
腙	月宀一一丶丶
胲	月亥丶一丶丶
腋	月夜丶一丶丶
臃	月亠ㄋㄋ一一
胶	月交丶一丶丶
肮	月亠ノㄋㄋㄋ
脍	月人一一丶丶
臆	月音丶ㄋ丶丶
脖	月孛ㄋ丨一一
胫	月轻ㄋ丶一一
腹	月复ノ一丶丶
腈	月青一一一一
腠	月ノ一丶丶
媵	月ㄋノ一一
滕	月丨丶丶丶
塍	月一丨一一
脱	月总ノㄋㄋㄋ
朕	月䒑一ノ丶丶
胼	月䒑一ノ丨丨
腺	月白丨ㄋ丶丶
脂	月旨ノㄋ一一
胪	月⺊ㄋ一ノノ
朦	月劳一一丶丶
膜	月莫一丨丶丶
腌	月大丨ㄋㄋㄋ
膊	月甫一丨丶丶
股	月殳ノㄋ丶丶
脶	月呙丨ㄋ丶丶
膦	月米ノㄋ丨丨
膝	月木ノ丶丶丶
腥	月日ノ一一一
胆	月旦丨ㄋ一一
胗	月㐱ノ丶ノノ
胩	月上丨丶丶丶
肢	月十ㄋ丶丶丶
胝	月氏丶丶丶丶
胎	月台ㄋ丶一一
腮	月田丶ㄋ丶丶
脐	月文ノ丨丨丨
脎	月乂一丨丶丶
腰	月覀ㄋノ一一
膘	月覀一一丶丶
腽	月日丨ㄋ一一
脬	月爫ㄋ丨一一
胳	月各ノㄋ一一
腊	月昔一丨一一
腾	月ㄋㄋ一一
服	月卩ㄋ丶丶丶
肥	月巴ㄋ丨ㄋㄋ
胁	月力ノ丶丶丶
刖	月刂丨丨丨丨
肘	月寸一丨丶丶
胨	月东一ㄋ丶丶
肪	月方丶一ノノ
肤	月夫一一丶丶
肺	月一丨ㄋ丨丨
脯	月甫一丨丶丶
肝	月干一一丨丨
膈	月鬲一丨丨丨
肛	月工一丨一一
胍	月瓜ノノ丶丶
肌	月几ノㄋㄋㄋ
胛	月甲丨ㄋ丨丨
肼	月井一一丨丨
肋	月力ㄋノノノ
胧	月龙一ノ丶丶
脒	月米丶ノ丶丶
腼	月丆丨ㄋ一一
肭	月内丨ㄋ丶丶
脓	月农丶ㄋノノ
胂	月日丨丨丨丨
胜	月生ノ一一一
豚	月豕一ノ丶丶
肚	月土一丨一一
肫	月屯一ㄋㄋㄋ
胰	月大ㄋ一ㄋㄋ
脉	月永丶ㄋ丶丶
腴	月臼ノ丶丶丶
朋	月月ノㄋ一一
胙	月乍ノ一一一
胀	月长ノ一丶丶
肿	月中丨ㄋ丨丨
脞	月从一丨一一
月	月ノㄋ一一
甩	月乚ㄋㄋㄋㄋ
朊	月二ノㄋㄋㄋ
臁	月广丶ノ丶丶
肜	月彡ノノノノ
膪	月帝丨ㄋ一一
膣	月穴一ㄋ一一
鹏	月月ノㄋ一一
胸	月勹ノ丶丨丨
腿	月艮丶ㄋ丶丶
脾	月卑ノ丨丨丨
膛	月一丨一一
脑	月㐫丶一丨丨
臊	月口丨ㄋ丶丶
腧	月俞ノ丶丨丨
脸	月佥ノ丶一一
胚	月不一一一一
胯	月大一一ㄋㄋ
肟	月亏一一ㄋㄋ
腩	月十丨ㄋ丨丨
腭	月吅一一ㄋㄋ
胖	月半丶ノ丨丨
腓	月非丨一一一
腘	月囗一一丶丶
胠	月去一丨丶丶
臜	月先ノ一丶丶
臑	月雨一ノ丨丨
螣	月丨ㄋ丶丶
縢	月ㄋㄋ丶丶
腨	月山一ノ丨丨
肸	月八一丨丨丨
脟	月爫一丨丶丶
脿	月ノㄋ丶丶
腒	月尸一丨一一
胈	月ㄋ丶丶丶
朏	月出ㄋ丨丨丨
早	早丨ㄋ丨丨
迮	乍辶丶ㄋ丶丶
怎	乍心丶ㄋ丶丶
乍	乍ノ一一一
点	占灬丶丶丶丶
占	占丨一一一
觇	占见丨ㄋㄋㄋ
战	占戈一ㄋ丶丶
乩	占乚ㄋㄋㄋㄋ
卤	占乂ノ丶丶丶
长	长ノ一丶丶
爬	爪巴ㄋ丨ㄋㄋ
爪	爪ノノ丶丶
遥	爫缶丶ㄋ丶丶
舜	受舛ノㄋ丨丨
爱	受ㄋ丶丶丶
受	受又ㄋ丶丶丶
舀	爫臼ノ丨一一
采	爫木一丨丶丶
妥	爫女ㄋノ一一
爵	爫罒ㄋ一丶丶
奚	爫幺一ノ丶丶
爰	爰ノ丶丶丶
孚	爫子ㄋ丨一一
虢	爫寸丨一ㄋㄋ
鹞	爫缶ノㄋ一一
繇	爫缶ノㄋ丶丶
彩	爫木ノノノノ
乳	爫子ㄋㄋㄋㄋ
郛	爫孑ㄋ丨丨丨
觅	爫见丨ㄋㄋㄋ
谿	爫幺一ノ一一
胥	疋⺝丨ㄋ一一
蛋	疋虫丨ㄋ丶丶
买	买ㄋ丶丶丶
乜	乚ㄋㄋㄋㄋ
敢	敢攵ノ一丶丶
疏	㐬丶一ㄋㄋ
憨	敢攵丶ㄋ丶丶
疍	疋旦丨ㄋ一一
之	之丶ㄋ丶丶
处	夂卜丨丶丶丶
逢	夂丰丶ㄋ丶丶
逄	夂㐄丶ㄋ丶丶
咎	夂卜丨ㄋ一一
昝	夂卜丨ㄋ一一
螽	夂⺀丨ㄋ丶丶
惫	夂田丶ㄋ丶丶
冬	夂⺀丶丶丶丶
各	各ノㄋ一一
务	夂力ㄋノノノ
条	夂朩一丨丶丶
备	夂田丨ㄋ一一
雒	各隹ノ丨一一
歧	止十ㄋ丶丶丶
此	此丨一ㄋㄋ
赀	此贝丨ㄋ丶丶
些	此二一一一一
觜	此角ノㄋ丨丨
柴	此木一丨丶丶
訾	此言丶一一一
肯	止⺝丨ㄋ一一
齿	齿丨一丨丨
步	止丨ノノノ
止	止丨一一一
砦	此石一ノ一一
雌	此隹ノ丨一一
龇	齿此丨一ㄋㄋ
龅	齿勹ㄋ一ㄋㄋ
龌	齿尸一ㄋ一一
龄	齿令ノ丶丶丶
龆	齿召ㄋノ一一
龊	齿足丨ㄋ丶丶
龉	齿五丨ㄋ一一
龀	齿匕ノㄋㄋㄋ
龈	齿艮ㄋ一丶丶
龃	齿且丨ㄋ一一
龋	齿禹ノ丨丶丶
频	止一ノ丶丶
颦	止一ノ丨丨
紫	此糸ㄋㄋ丶丶
龂	齿斤ㄋ丨丨丨
龁	齿ㄋㄋㄋㄋ
至	至一ㄋ一一
臻	至ノ一丶丶
到	至刂丨丨丨丨
致	至攵ノ一丶丶
郅	至阝ㄋ丨丨丨
貅	豸亻一丨丶丶
豹	豸勹丶丶丶丶
貔	豸囟ノ丶ㄋㄋ
貌	豸白ノㄋㄋㄋ
貘	豸莫一丨丶丶
貂	豸召ㄋノ一一
貊	豸百一ノ一一
貉	豸各ノㄋ一一
豺	豸才一丨ノノ
邈	豸白ノㄋ丶丶
豸	豸ノ丶ノノ
掣	巾丨丨丨丨
制	巾丨丨丨丨
重	千里丨ㄋ一一
熏	千黑丨ㄋ丶丶
舭	舟比一ㄋㄋㄋ
艇	舟壬ㄋ丶丶丶
艉	舟尸ノ一ㄋㄋ
舣	舟丶ノ丶丶丶
艚	舟曹一丨一一
舵	舟宀ノㄋㄋㄋ
航	舟亠ノㄋㄋㄋ
舷	舟玄丶一丶丶
艄	舟肖丨丶一一
舻	舟⺊ㄋ一ノノ
艨	舟劳一一丶丶
般	舟殳ノㄋ丶丶
船	舟几丨ㄋ一一
艟	舟立丨ㄋ一一
舱	舟仓ノ丶ㄋㄋ
艘	舟臼丨ㄋ丶丶
艋	舟子丨ㄋ一一
艏	舟䒑ノ丨一一
舶	舟白ノ丨一一
舫	舟方丶一ノノ
舢	舟山丨ㄋ丨丨
舴	舟乍ノ一一一
舯	舟中丨ㄋ丨丨
磐	舟殳一ノ一一
盘	舟皿丨ㄋ一一
舟	舟ノノ丶丶
舨	舟ㄋ丶丶丶
舡	舟工一丨一一
舸	舟可一丨丨丨
舰	舟见丨ㄋㄋㄋ
舾	舟西一丨一一
舳	舟由丨ㄋ一一
舲	舟令ノ丶丶丶
鸼	舟鸟ノㄋ一一
艎	舟白一一一一
舠	舟刀ㄋノノノ
艅	舟余ノ丶丶丶
舥	舟巴ㄋ丨ㄋㄋ
竹	竹ノ一丨丨
主	主丶一一一
将	丬夕一丨丶丶
妆	丬女ㄋノ一一
状	丬犬一ノ丶丶
壮	丬士一丨一一
装	丬士丶一丶丶
奖	奖大一ノ丶丶
桨	奖木一丨丶丶
浆	奖水丨ㄋ丶丶
酱	奖酉一丨一一
雠	隹讠ノ丨一一
焦	隹灬丶丶丶丶
售	隹口丨ㄋ一一
集	隹木一丨丶丶
隽	隹乃ㄋノノノ
隼	隹十一丨丨丨
隹	隹ノ丨一一
鹪	隹灬ノㄋ一一
劁	隹灬丨丨丨丨
孟	子皿丨ㄋ一一
子	子ㄋ丨一一
勐	子皿ㄋノノノ
鼻	自畀丨ㄋ丨丨
臬	自木一丨丶丶
臭	自犬一ノ丶丶
息	自心丶ㄋ丶丶
自	自ノ丨一一
齄	自畀一丨一一
劓	自畀丨丨丨丨
鼾	自畀一一丨丨
鼽	自畀ノㄋㄋㄋ
谏	讠柬一丨丶丶
趔	走歹丨丨丨丨
趣	走耳ㄋ丶丶丶
趑	走次丶一丶丶
趱	走先ノ一丶丶
趋	走刍ノㄋ一一
趟	走尚丨丶一一
超	走召ㄋノ一一
趁	走㐱ノ丶ノノ
赴	走卜丨丶丶丶
赶	走干一一丨丨
起	走己ㄋ一ㄋㄋ
赳	走丩ㄋ丨丨丨
趄	走且丨ㄋ一一
赵	走乂ノ丶丶丶
走	走一丨丶丶
越	走戉一ㄋ丶丶
趯	走羽ノ丨一一
足	足丨ㄋ丶丶
卒	卒丶一丨丨
膂	族丨ㄋ一一
旅	族ノㄋ丶丶
旎	族尸ノㄋㄋㄋ
旗	族其一丨丶丶
旒	族㐬丶一ㄋㄋ
旖	族大一丨丨丨
旋	族疋ㄋ丨丶丶
旃	族丹ノㄋ一一
旆	族一丨ㄋ丨丨
旄	族毛ノ一ㄋㄋ
旌	族生ノ一一一
族	族矢ノ一丶丶
施	族也ㄋ丨ㄋㄋ
附	阝付ノ丨丶丶
陬	阝耳ㄋ丶丶丶
陶	阝勹ノ一丨丨
隧	阝㒸丶ㄋ丶丶
随	阝ノㄋ丶丶
阪	阝ㄋ丶丶丶
陆	阝ㄋ丨丨丨
陛	阝比一丨一一
隋	阝一丨一一
隐	阝刍丶ㄋ丶丶
院	阝宀一一ㄋㄋ
陀	阝宀ノㄋㄋㄋ
陔	阝亥丶一丶丶
陉	阝轻ㄋ丶一一
阶	阝人ノ丨丨丨
隘	阝䒑ノ丶一一
陷	阝ノ丨一一
隍	阝白一一一一
阽	阝占丨一一一
陨	阝口丨ㄋ丶丶
陪	阝立丨ㄋ一一
隰	阝日ㄋㄋ丶丶
隈	阝田一ㄋ丶丶
陵	阝土ノ丶丶丶
陡	阝走一丨丶丶
隙	阝小丨ㄋ丶丶
陌	阝百一ノ一一
阮	阝元一一ㄋㄋ
陧	阝日一丨一一
降	阝夂一ㄋ丨丨
隆	阝夂一ノ一一
陟	阝止丨ノノノ
阵	阝车一ㄋ丨丨
陲	阝垂ノ一一一
陈	阝东一ㄋ丶丶
防	阝方丶一ノノ
隔	阝鬲一丨丨丨
隗	阝鬼ノ丨丶丶
陕	阝夹ノ丶丶丶
阱	阝井一一丨丨
陇	阝龙一ノ丶丶
陂	阝皮ㄋノ丶丶
阡	阝千ノ一丨丨
队	阝人ノ丶丶丶
阳	阝日丨ㄋ一一
际	阝示一一丶丶
阴	阝月ノㄋ一一
阼	阝乍ノ一一一
隳	阝一丨丶丶
堕	阝ノㄋ一一
骘	阝止丨ノ一一
坠	阝人一丨一一
阢	阝一ノㄋㄋㄋ
阿	阝可一丨丨丨
陋	阝丙ノ丶ㄋㄋ
陴	阝卑ノ丨丨丨
险	阝佥ノ丶一一
除	阝余ノ丶丶丶
障	阝音一丨丨丨
限	阝艮ㄋ一丶丶
隅	阝禺丨ㄋ丶丶
隃	阝俞ノ丶丨丨
隩	阝向丶ノ丶丶
送	䒑大丶ㄋ丶丶
迸	䒑廾丶ㄋ丶丶
道	䒑自丶ㄋ丶丶
翦	前羽ㄋ丶一一
剪	前刀ㄋノノノ
煎	前灬丶丶丶丶
普	並日丨ㄋ一一
益	䒑八丨ㄋ一一
夔	䒑自丨一丶丶
关	䒑大一ノ丶丶
并	䒑廾一ノ丨丨
兰	兰丶ノ一一
前	前丶ノ丨丨
首	䒑自ノ丨一一
蠲	䒑八丨ㄋ丶丶
郑	䒑大ㄋ丨丨丨
瓶	䒑廾一ㄋ丶丶
鹚	䒑幺ㄋㄋ一一
馘	䒑自一ㄋ一一
慈	䒑幺ㄋㄋ丶丶
孳	䒑幺ㄋㄋ一一
兹	䒑幺ㄋㄋ丶丶
鹢	䒑八丨ㄋ一一
陞	阝丿一ノ一一
盦	今酉丨ㄋ一一
镵	钅丨ㄋ丶丶
耰	耒丆丨ㄋ丶丶
襫	衤一一ノ丶丶
盉	禾皿丨ㄋ一一
鲖	鱼冂丨ㄋ一一
蒱	艹扌一丨丶丶
祊	礻方丶一ノノ
鄀	艹丨ㄋ丨丨
矼	石工一丨一一
腯	月一丨一一
纼	纟弓丨丨丨丨
逴	卓辶丶ㄋ丶丶
菼	艹炎丶ノ丶丶
鼒	才目ㄋ一ㄋㄋ
筤	良丶ㄋ丶丶
簉	告丶ㄋ丶丶
镋	钅ノㄋㄋㄋ
鄅	禹阝ㄋ丨丨丨
馌	饣去丨ㄋ一一
耏	而彡ノノノノ
芣	艹不一ノ丶丶
辿	山辶丶ㄋ丶丶
鸤	尸鸟ノㄋ一一
糒	米ノノ丨丨
靽	革半丶ノ丨丨
讻	讠乂ㄋ丨丨丨
骦	马雨一丨一一
靬	革干一一丨丨
荓	艹䒑一ノ丨丨
貆	豸一丨ㄋ一一
莝	艹从一丨一一
蹢	啇丶一一一
羓	巴ㄋ丨ㄋㄋ
硿	石穴一丨一一
竫	立争ノㄋ丨丨
笯	女ㄋ丶丶丶
衃	扌丿丨ㄋ一一
羱	厂ノ丨丶丶
荁	艹一丨ㄋ一一
蟏	虫艹ㄋ一丶丶
褟	衤日ㄋ丶一一
砆	石夫一一丶丶
鄌	广肀丨ㄋ丨丨
砠	石且丨ㄋ一一
硍	石艮ㄋ一丶丶
蔈	艹覀一一丶丶
蚆	虫巴ㄋ丨ㄋㄋ
鞁	革皮ㄋノ丶丶
碈	石氏丨ㄋ一一
礵	石雨一丨一一
豮	豕十一丨丶丶
陑	阝而一ノ丨丨
盷	目勹丶一一一
禒	礻彖ㄋㄋ丶丶
翷	米舛ㄋ丶一一
胣	月ㄋ丨ㄋㄋ
鞳	革艹ノ丶一一
齇	自畀丨一一一
萹	艹户丨ㄋ丨丨
蓢	艹朗ノㄋ一一
蝲	虫束丨丨丨丨
㑇	亻刍ノㄋ一一
㑊	亻亦丶一丶丶
㕮	口父ノ丶丶丶
㘎	口门ㄋ一丶丶
㙍	土双ㄋ丶丶丶
㙘	土覀ㄋノ一一
㙦	余⺀一丨一一
㛃	丰刀ㄋノ一一
㛹	女亻一丨丶丶
㟃	山丨ㄋ一一
㠇	山京一ノ丶丶
㠓	山劳一一丶丶
㤘	忄刍ノㄋ一一
㧐	扌双ㄋ丶丶丶
㧑	扌为丶ノ丶丶
㧟	扌氵一ㄋㄋㄋ
㫰	日良丶ㄋ丶丶
㬊	日爰ノ丶丶丶
㬎	日ㄋㄋ丶丶
㬚	日丨ㄋ丶丶
㭎	木冈丨ㄋ丶丶
㮾	朗月一丨丶丶
㰀	木禾ノㄋ丶丶
㳇	氵父ノ丶丶丶
㳘	氵ノㄋㄋㄋ
㳚	氵戊丶丶丶丶
㴔	氵刍丶ㄋ丶丶
㵐	水厂丶ノ丶丶
㶲	火用ノㄋ丨丨
㸆	火告丨一一一
㸌	火雨ノ丨一一
㻬	王雨一一ㄋㄋ
㽏	氵合一丨一一
㿠	白光丨丶ㄋㄋ
䁖	目米ㄋノ一一
䂮	丰刀一ノ一一
䃅	石单丶ノ丨丨
䃎	石大ノㄋ丶丶
䎃	冉羽ㄋ丶一一
䏝	月专一一丶丶
䏡	月示一一丶丶
䏲	月弟丶ノノノ
䐃	月囗ノ一丶丶
䓖	艹穴ㄋノノノ
䓛	艹尸ㄋ丨丨丨
䓬	艹卓丨一丨丨
䕫	艹白丨一丶丶
䗖	虫带一丨丨丨
䗛	虫亻丨ノ一一
䗪	度灬丨ㄋ丶丶
䗴	虫ノ一丶丶
䜣	讠斤ノノ丨丨
䝙	豸区一ノㄋㄋ
䦃	钅艹一丨一一
䲟	鱼ㄋ丨丨丨
䲠	鱼丨ㄋ一一
䲢	月ノㄋ一一
䴓	一巾ノㄋ一一
䴔	交鸟ノㄋ一一
䴕	歹刂ノㄋ一一
䴗	日犬ノㄋ一一
䴘	虍ノㄋ一一
䴙	辟鸟ノㄋ一一
丏	正ㄋㄋㄋㄋ
乸	也母ㄋㄋ丶丶
亶	亠回丨ㄋ一一
亸	享单丶ノ丨丨
亹	亠冂丨ㄋ一一
伾	亻不一一一一
佁	亻台ㄋ丶一一
佸	亻舌ノ一一一
佺	亻人一一一一
佽	亻次丶一丶丶
侁	亻先ノ一ㄋㄋ
侂	亻广ノ一ㄋㄋ
侘	亻宀ノ一ㄋㄋ
侴	人一ㄋ丨丨丨
俍	亻良丶ㄋ丶丶
俶	亻上丨ノ丶丶
倓	亻炎丶ノ丶丶
倕	亻垂ノ一一一
倧	亻宀一一丶丶
倴	亻大一丨丨丨
倻	亻耳ㄋ丨丨丨
偁	亻爫丨ㄋ一一
偓	亻尸一ㄋ一一
偡	亻其ㄋㄋㄋㄋ
偭	亻丆丨ㄋ一一
偲	亻田丶ㄋ丶丶
傃	亻ㄋㄋ丶丶
傉	亻辰一丨丶丶
僎	亻巳ㄋ一丶丶
僔	亻酋一丨丶丶
僰	朿朿ノ丶丶丶
儳	亻丨ㄋ丶丶
冏	冏丨ㄋ一一
冔	日口一一丨丨
冮	冫工一丨一一
凓	冫覀一丨丶丶
凘	冫其ノノ丨丨
刬	戋刂丨丨丨丨
剅	豆刂丨丨丨丨
剋	古儿丨丨丨丨
剕	非刂丨丨丨丨
剟	双双丨丨丨丨
劄	合丨丨丨丨
劼	吉力ㄋノノノ
勔	丆囬ㄋノノノ
勚	世贝ㄋノノノ
匜	匚也ㄋ丨ㄋㄋ
卬	卩ㄋ丨丨丨
厖	厂尢ノノ丶丶
叆	云受一ノ丶丶
叇	云隶丶ㄋ丶丶
叕	双双ㄋ丶丶丶
叚	叚ㄋ一丶丶
吽	口牛ノ一丨丨
呇	水口丨ㄋ一一
呣	口母ㄋㄋ丶丶
咉	口央丨ㄋ丶丶
咍	口台ㄋ丶一一
咡	口耳一丨一一
咺	口一丨ㄋ一一
哃	口冂丨ㄋ一一
哢	口王一ノ丨丨
哱	口十丶ㄋ一一
唝	口工丨ㄋ丶丶
唵	口大丨ㄋㄋㄋ
啰	口罒ノㄋ丶丶
啴	口单丶ノ丨丨
喆	吉吉一丨一一
嗐	口宀一一一一
嘚	口彳丨ㄋ丶丶
噀	口巳ㄋ一丶丶
噂	口酋一丨丶丶
嚭	壴口一ノ一一
囷	囗禾ノ一丶丶
圐	囗罒丶一ノノ
圙	囗八一ノ一一
圢	丁一丨丨丨
圫	乇ノ一ㄋㄋ
圲	千ノ一丨丨
坒	比土一丨一一
坥	且丨ㄋ一一
坬	瓜ノノ丶丶
坽	令ノ丶丶丶
垈	代土一丨一一
垍	自ノ丨一一
垏	聿ㄋ一丨丨
垙	光丨丶ㄋㄋ
垚	土一丨一一
垞	宀ノ一ㄋㄋ
垟	羊丶ノ丨丨
垵	宀ㄋノ一一
垺	爫ㄋ丨一一
垾	日一一丨丨
垿	广ㄋ丶丨丨
埌	良丶ㄋ丶丶
埗	止丨ノノノ
埪	穴一丨一一
埫	尚丨丶一一
埵	垂ノ一一一
堃	方方一丨一一
堉	丨ㄋ一一
堌	囗一丨一一
堐	厂一丨一一
堧	土而一ノ丶丶
堲	卩一丨一一
堼	圭寸一丨一一
堽	罒一丨一一
堾	丨ㄋ一一
塅	段ノ丨丶丶
塆	亦ㄋ一ㄋㄋ
塱	朗月一丨一一
墐	堇一丨一一
墕	正一ㄋ丶丶
墘	一ノㄋㄋ
墡	羊丶ノ一一
壸	壳亚一丨一一
夐	𠔿丨ㄋ丶丶
夬	夬ㄋ一丶丶
奡	丆目一ノ丨丨
奭	大百一ノ一一
妘	女云一一丶丶
妧	女元一一ㄋㄋ
姈	女令ノ丶丶丶
姞	女吉一丨一一
姮	女一丨ㄋ一一
姱	女大一一ㄋㄋ
娀	女戈一ノノノ
娵	女耳ㄋ丶丶丶
婌	女上丨ノ丶丶
婘	女ㄋㄋㄋㄋ
婞	女土丶ノ丨丨
婠	女宀丨ㄋ一一
婳	女一丨ㄋ丨丨
婻	女十丨ㄋ丨丨
婼	女艹一ノ一一
媄	女一ノ丶丶
媆	女而一ノ丶丶
媭	彡页ㄋノ一一
媱	女爫ノ一丨丨
嫄	女厂ノ丨丶丶
嫕	女匚ノ一丶丶
嫚	女日丨ㄋ丶丶
嫭	女虍ノ丶丨丨
嬿	女廿丨ㄋ丶丶
孅	女从一ㄋ一一
孖	子子ㄋ丨一一
宬	宀戊ㄋㄋㄋㄋ
寁	宀妻丨一丶丶
尨	尢彡丶丶丶丶
尪	尢王一一一一
屾	山山丨ㄋ丨丨
岊	巴山丨ㄋ丨丨
岨	山且丨ㄋ一一
峂	山夂丶丶丶丶
峃	学山丨ㄋ丨丨
峏	山而一ノ丨丨
峘	山一丨ㄋ一一
峛	山歹丨丨丨丨
峣	山尧一ㄋㄋㄋ
峧	山交丶一丶丶
峱	犭丑丨ㄋ丨丨
崀	山良丶ㄋ丶丶
崁	山土ノㄋ丶丶
崄	巾佥ノ丶一一
崟	山金ノ丶一一
崡	山了丶一丨丨
崶	山圭一丨丶丶
崿	山吅一一ㄋㄋ
嵁	山其ㄋㄋㄋㄋ
嵚	山钅ノㄋ丶丶
嵲	山自一丨丶丶
嶅	敖山丨ㄋ丨丨
嶟	山酋一丨丶丶
嶲	山隹丨ㄋㄋㄋ
巉	山丨ㄋ丶丶
帡	巾䒑一ノ丨丨
帨	巾总ノㄋㄋㄋ
幖	巾覀一一丶丶
幪	巾劳一一丶丶
庤	广土一丨丶丶
庼	广一ノ丶丶
廋	广臼丨ㄋ丶丶
廙	广田一丨丶丶
弢	弓山ㄋ丶丶丶
弨	弓召ㄋノ一一
弸	弓月ノㄋ一一
彧	弋口一ノノノ
忞	文心丶ㄋ丶丶
忺	忄欠ノㄋ丶丶
恓	忄西一丨一一
恔	忄交丶一丶丶
悈	忄戈一ノ丨丨
悢	忄良丶ㄋ丶丶
悰	忄宀一一丶丶
惇	忄享丶一一一
惔	忄炎丶ノ丶丶
惙	忄双ㄋ丶丶丶
惛	忄氏丨ㄋ一一
愃	忄㝉丨ㄋ一一
愐	忄丆丨ㄋ一一
愔	忄音丶一一一
愭	忄耂ノㄋ一一
慆	忄爫ノ丨一一
慥	忄告丶ㄋ丶丶
慬	忄堇一丨一一
憕	忄登ㄋ丶一一
憙	壴口丶ㄋ丶丶
戭	㝉由ノ丶丶丶
扞	扌干一一丨丨
抃	扌丶一丨丶丶
抔	扌不一ノ丶丶
拤	扌上丨丶丶丶
挓	扌宀ノ一ㄋㄋ
挦	扌彐一丨丶丶
捯	扌至丨丨丨丨
掞	扌炎丶ノ丶丶
揕	扌其ㄋㄋㄋㄋ
摏	扌ノ丨一一
摴	扌雨一一ㄋㄋ
摽	扌覀一一丶丶
擿	扌商丶ㄋ丶丶
敩	学子ノ一丶丶
斝	吅冖丶丶丨丨
斠	冓⺀一丨丨丨
旐	方ノㄋ丶丶
旵	日山丨ㄋ丨丨
旻	日文丶一丶丶
旿	日一丨丨丨
昄	日ㄋ丶丶丶
昇	日丿一ノ丨丨
昉	日方丶一ノノ
昒	日勿ノㄋノノ
昤	日令ノ丶丶丶
昪	日厶一ノ丨丨
昳	日丿一一丶丶
昺	日丙ノ丶丶丶
晅	日一丨ㄋ一一
晙	日夋ㄋ丶丶丶
晢	折日丨ㄋ一一
晪	日曲ノ丶丶丶
晫	日卓丨一丨丨
晱	日炎丶ノ丶丶
暅	日忄一丨一一
暕	日柬一丨丶丶
暲	日音一丨丨丨
暵	日廿丨ㄋ丶丶
暶	日族ㄋ丨丶丶
暿	日壴丨ㄋ一一
曌	日月丶丶一一
朓	月儿丶一丶丶
朳	木八ノ丶丶丶
朸	木力ㄋノノノ
杄	木千ノ一丨丨
杕	木大一ノ丶丶
杙	木弋一ㄋ丶丶
杧	木亡丶一ㄋㄋ
杻	木丑ㄋ丨一一
枍	木八一ㄋㄋㄋ
枲	台木一丨丶丶
枹	木勹ㄋ一ㄋㄋ
柈	木半丶ノ丨丨
柊	木夂丶丶丶丶
柖	木召ㄋノ一一
柷	木口ノㄋㄋㄋ
栐	木永丶ㄋ丶丶
栒	木勹丨ㄋ一一
栟	木䒑一ノ丨丨
栴	木ノㄋ一一
栻	木弋一丨一一
桯	木口一一一一
桲	木十丶ㄋ一一
桹	木良丶ㄋ丶丶
梣	木山ノ丶ㄋㄋ
梴	木丿丨一丶丶
梼	木一丨丶丶
梽	木士丶ㄋ丶丶
梿	木车丶ㄋ丶丶
棁	木总ノㄋㄋㄋ
棐	非木一丨丶丶
棓	木立丨ㄋ一一
棨	户攵一丨丶丶
棪	木炎丶ノ丶丶
棫	木戈丨ㄋ一一
棬	木ㄋㄋㄋㄋ
棻	艹分一丨丶丶
椀	木宀ノㄋㄋㄋ
椑	木卑ノ丨丨丨
椓	木豕丶丶丶丶
椪	木並丶ノ一一
椸	木族ㄋ丨ㄋㄋ
楒	木田丶ㄋ丶丶
楩	木亻一丨丶丶
楪	木世一丨丶丶
楯	木一丨一一
榰	木耂ノㄋ一一
槃	舟殳一丨丶丶
槚	木覀丨ㄋ丶丶
槜	木隹ㄋノノノ
槱	木酉丶丶丶丶
橞	木惠丶ㄋ丶丶
櫆	木鬼丶丶丨丨
欂	木落一丨丶丶
欸	厶矢ノㄋ丶丶
欻	炎欠ノㄋ丶丶
殣	歹堇一丨一一
毌	毌ㄋㄋ一一
毐	士毋ㄋㄋ一一
氾	氵㔾ㄋㄋㄋㄋ
氿	氵九ノㄋㄋㄋ
汈	氵一一一一
汋	氵勹丶丶丶丶
汫	氵井一一丨丨
汭	氵内丨ㄋ丶丶
沄	氵云一一丶丶
沇	氵厶ノㄋㄋㄋ
沘	氵比一ㄋㄋㄋ
沚	氵止丨一一一
沺	氵田丨ㄋ一一
泇	氵加ㄋノ一一
泙	氵平一丶丨丨
泜	氵氏丶丶丶丶
洑	氵亻一ノ丶丶
洓	氵朿一丨丶丶
洘	氵耂一ㄋㄋㄋ
洢	氵亻ㄋ一ノノ
洣	氵米丶ノ丶丶
洨	氵交丶一丶丶
洭	氵匚一一一一
洴	氵䒑一ノ丨丨
洸	氵光丨丶ㄋㄋ
洺	氵夕丨ㄋ一一
洿	氵大一一ㄋㄋ
浉	氵一丨丨丨
浐	氵产丶一ノノ
浕	氵尺丶丶丶丶
浛	氵今丨ㄋ一一
浟	氵攸ノ一丶丶
浡	氵十丶ㄋ一一
浥	氵口ㄋ丨ㄋㄋ
浬	氵里丨ㄋ一一
浭	氵更一丨丶丶
浰	氵禾丨丨丨丨
浲	氵夂一一丨丨
涄	氵由一ㄋㄋㄋ
涍	氵耂ㄋ丨一一
涐	氵我ノ一丶丶
涘	氵厶ノ一丶丶
涢	氵口丨ㄋ丶丶
涴	氵宀ノㄋㄋㄋ
淏	氵日一一丶丶
淜	氵月ノㄋ一一
淟	氵曲ノ丶丶丶
淯	氵丨ㄋ一一
淴	氵勿丶ㄋ丶丶
渟	氵亮一ノ丶丶
渰	氵合一ノ丨丨
渼	氵一ノ丶丶
湉	氵忄ノ一一一
湝	氵比ノ丨一一
湣	氵民丨ㄋ一一
湲	氵爰ノ丶丶丶
湴	氵並丶ノ一一
溁	氵劳一丨丶丶
溇	氵米ㄋノ一一
溚	氵艹ノ丶一一
溞	氵又丶丨丶丶
溠	氵一丨一一
溦	氵山一ノ丶丶
溵	氵ㄋ一丶丶
溹	氵孛ㄋㄋ丶丶
滉	氵日丨丶ㄋㄋ
滍	氵蚩ㄋ丨丶丶
滘	氵冖ノ丶一一
滧	氵交ノ一丶丶
滪	氵予一ノ丶丶
滫	氵攸ノ一一一
漋	氵阝ノㄋ一一
漖	氵耂ㄋ丨丶丶
漦	未攵一ノ丶丶
漴	氵山丶丶丶丶
漷	氵享ㄋ丨丨丨
漹	氵正一ㄋ丶丶
漼	氵山ノ丨一一
潖	氵王一一ㄋㄋ
潟	氵臼ノㄋ丶丶
潩	氵田一丨丶丶
潵	氵丨ㄋ丶丶
潽	氵並丨ㄋ一一
潾	氵米ノㄋ丨丨
澂	氵山一ノ丶丶
澛	氵鱼丨ㄋ一一
澪	氵雨ノ丶丶丶
澭	氵亠ㄋㄋ一一
澼	氵辟ㄋ一丨丨
澽	氵虍一ノ丶丶
濋	氵林ㄋ丨丶丶
瀍	氵广丨ㄋ一一
瀔	氵壳一ノ丶丶
瀱	氵罒一ノ丨丨
灈	氵目丨ㄋ一一
炆	火文丶一丶丶
炌	火人ノ丨丨丨
炘	火斤ノノ丨丨
炟	火旦丨ㄋ一一
炣	火可一丨丨丨
烔	火冂丨ㄋ一一
烜	火一丨ㄋ一一
烝	丞灬丶丶丶丶
烠	火丨ㄋ一一
烺	火良丶ㄋ丶丶
烻	火丿丨一丶丶
焌	火夋ㄋ丶丶丶
焗	火尸ㄋ丨一一
焞	火享丶一一一
煁	火其ㄋㄋㄋㄋ
煃	火大一丨一一
煋	火日ノ一一一
煟	火田ノㄋ一一
熛	火覀一一丶丶
熜	火囟ノㄋ丶丶
熥	火甬丶ㄋ丶丶
熻	火合ㄋ丶一一
燊	火火丶ノ丶丶
燋	火隹丶丶丶丶
燚	炎炎丶ノ丶丶
爇	艹土ノ丶丶丶
爔	火ノ一丶丶
爟	火艹丨ㄋ一一
牁	爿可一丨丨丨
牂	爿羊丶ノ丨丨
牚	牙一ㄋノノ
牤	牜亡丶一ㄋㄋ
牥	牜方丶一ノノ
牻	牜尢ノノ丶丶
犇	牛牛ノ一丨丨
犨	隹隹ノ一丨丨
狉	犭不一一一一
狝	犭尔ノㄋ丶丶
猺	犭爫ノ一丨丨
獴	犭劳一一丶丶
玃	犭目丨ㄋ丶丶
玒	王工一丨一一
玓	王勹丶丶丶丶
玕	王干一一丨丨
玘	王己ㄋ一ㄋㄋ
玙	王与一一一一
玞	王夫一一丶丶
玠	王人ノ丨丨丨
玡	王牙一ㄋノノ
玤	王丰一一丨丨
玥	王月ノㄋ一一
玭	王比一ㄋㄋㄋ
玶	王平一丶丨丨
玿	王召ㄋノ一一
珅	王日丨丨丨丨
珇	王且丨ㄋ一一
珋	王卯ㄋ丨丨丨
珒	王聿ㄋ一丨丨
珕	王力ㄋノノノ
珖	王光丨丶ㄋㄋ
珛	王丨ㄋ一一
珝	王羽ㄋ丶一一
珢	王艮ㄋ一丶丶
珣	王勹丨ㄋ一一
珦	王向丨ㄋ一一
珫	王ノㄋㄋㄋ
珵	王口一一一一
珹	王戊ㄋㄋㄋㄋ
珽	王丿丨一丶丶
琀	王今丨ㄋ一一
琇	王禾ㄋノノノ
琈	王爫ㄋ丨一一
琎	王井丶ㄋ丶丶
琔	王定丶丶丶丶
琟	王隹ノ丨一一
琡	王上丨ノ丶丶
琤	王争ノㄋ丨丨
琫	王一一丨丨
琯	王宀丨ㄋ一一
琲	王非丨一一一
瑀	王禹ノ丨丶丶
瑃	王丨ㄋ一一
瑄	王㝉丨ㄋ一一
瑆	王日ノ一一一
瑑	王彖ㄋㄋ丶丶
瑓	王柬一丨丶丶
瑖	王段ノ丨丶丶
瑧	王ノ一丶丶
瑬	氵㐬一一丶丶
瑳	王一丨一一
璈	王敖一一丶丶
璒	王登ㄋ丶一一
璘	王米ノㄋ丨丨
璟	王日丶一丶丶
璥	王芍ノㄋ丶丶
璪	王口丨ㄋ丶丶
璬	王白丶一丶丶
璱	王王一一丶丶
瓖	王襄丶一丶丶
瓘	王艹丨ㄋ一一
甡	生生ノ一一一
甦	更生ノ一一一
甪	丿用ノㄋ丨丨
畖	田瓜ノノ丶丶
畤	田土一丨丶丶
畯	田夋ㄋ丶丶丶
疢	疒火丶ノ丶丶
疭	疒从ノ丶丶丶
癗	疒雨丨ㄋ一一
癿	白乙ㄋㄋㄋㄋ
皕	百百一ノ一一
皛	白白ノ丨一一
皞	白白一ノ丨丨
皦	白白丶一丶丶
皭	白爫丨ㄋ丶丶
砵	石木一一一一
膙	月弓丨ㄋ丶丶
苉	艹匚ノㄋㄋㄋ
茋	艹氏丶丶丶丶
萣	艹定丶丶丶丶
萳	艹十丨ㄋ丨丨
蔃	艹弓丨ㄋ丶丶
薸	落覀一一丶丶
蚲	虫平一丶丨丨
蛃	虫丙ノ丶丶丶
觃	见子ㄋ丨一一
陎	阝丿一一丶丶
馞	禾日一丨一一
骉	马马ㄋㄋ一一
鹲	劳一一ノ一一
齉	自畀一丨丶丶
矇	目艹一丨丨丨
囧	冏一一一一一
慓	忄覀一一丶丶
揾	扌日丨ㄋ一一
琍	王禾丨丨丨丨
檵	木幺ㄋㄋㄋㄋ
枒	木牙一ㄋノノ
屌	尸口丨ㄋ丨丨
蹓	留丨ㄋ一一
蠧	壳石丨ㄋ丶丶
俬	亻禾ㄋ丶丶丶
粬	米曲丨ㄋ一一
歔	虍业ノㄋ丶丶
誌	言士丶ㄋ丶丶
砢	石可一丨丨丨
頔	由丆丨ㄋ丶丶
娭	女厶ノ一丶丶
彿	彳弓ノ丨丨丨
嘢	口里ㄋ丶丨丨
傢	亻宀一ノ丶丶
冇	冂丨ㄋㄋㄋ
碁	其石一ノ一一
袴	衤大一一ㄋㄋ
毑	母也ㄋ丨ㄋㄋ
濛	氵劳一一丶丶
嬅	女艹一丨丨丨
觍	曲八丨ㄋㄋㄋ
乂	乂ノ丶丶丶
𬉼	火区一ノㄋㄋ
𠳐	口ㄋ丨丨丨
𥻗	米木丨ㄋ一一
齁	自畀ノㄋ一一
彳	彳ノノ丨丨
𠙶	了凵ㄋ丨丨丨
𬣙	讠于一一丨丨
𨙸	十又ㄋ丨丨丨
𬇕	氵万一ㄋノノ
𬣞	讠㝉丶丶一一
𬘓	纟川ノ丨丨丨
𫭟	区一ノㄋㄋ
𫭢	人ノㄋㄋㄋ
𫇭	艹为丶ノ丶丶
𫐄	车兀一ノㄋㄋ
𫵷	山厂一ㄋノノ
𣲘	氵一一ノㄋㄋ
𣲗	氵韦一一丨丨
𬇙	氵贝丨ㄋ丶丶
𬣡	讠戋一一丶丶
𫸩	弓区一ノㄋㄋ
𨚕	厶廾ㄋ丨丨丨
𫘜	马文丶一丶丶
𬘘	纟冖ノㄋㄋㄋ
𫘝	马夬ㄋ一丶丶
𦭜	艹口ノ丶丶丶
𬨂	车氏ノㄋㄋㄋ
𬀩	日韦一一丨丨
𬀪	日见丨ㄋㄋㄋ
𬬩	钅弋一ㄋ丶丶
𫍣	讠冂丨ㄋ一一
𬣳	讠艮ㄋ一丶丶
𬩽	彐寸ㄋ丨丨丨
𬮿	阝己ノㄋㄋㄋ
𬯀	阝文ノ丨丨丨
𫰛	女轻ㄋ丶一一
𬳵	马不一一一一
𬳶	马冂丨ㄋ一一
𫠊	马玄丶一丶丶
𬍛	王丨ノ丶丶
鿍	夂一ㄋ丨丨
𬜬	艹门丨ㄋ一一
𦰡	艹ㄋ丨丨丨
𪾢	目见丨ㄋㄋㄋ
耑	山而一ノ丨丨
𪨰	山曲丨ㄋ一一
𫓧	钅夫一一丶丶
𬬮	钅长ノ一丶丶
𬬱	钅斤ノノ丨丨
𬬭	钅人ノㄋㄋㄋ
𦙶	月古一丨一一
𬘡	纟因丨ㄋ一一
𬳽	马先ノ一ㄋㄋ
𬘩	纟丿丨一丶丶
𪟝	贝ㄋノノノ
𬍤	王彐一丨丶丶
𫭼	劳ㄋノノノ
𬜯	艹丙ノ丶丶丶
𬂩	木夹ノ丶丶丶
𫠆	十又一ノ丶丶
𨐈	车光丨丶ㄋㄋ
𬌗	牙合ノ丶一一
𫑡	口日ㄋㄋ丨丨
𪨶	山大一ㄋ丨丨
𬬸	钅木丶丶丶丶
𬬻	钅⺊ㄋ一ノノ
𬬹	钅日丨丨丨丨
𬬿	钅召ㄋノ一一
𬭁	钅母ㄋㄋ丶丶
𫢸	亻单丶ノ丨丨
𫗧	饣束一丨丶丶
𬊈	火彐一丨丶丶
𬒈	学石一ノ一一
𨺙	阝臼ノㄋㄋㄋ
𬳿	马余ノ丶丶丶
𫄨	纟希ノ丶丨丨
𬘫	纟宀一一ㄋㄋ
𫮃	单丶ノ丨丨
鿎	石大丶ㄋ丶丶
𬱖	由页一ノ丶丶
𬟽	虫东一ㄋ丶丶
𫓯	钅圭一丨一一
𫟹	钅共一丨丶丶
𫟼	钅大丶ㄋ丶丶
𠅤	亠田丶ㄋ丶丶
𬇹	氵囗一一丶丶
𬍡	氵汤一一一一
𬤇	讠覀一丨一一
𫍯	讠咸一ノ丶丶
𬤊	讠是丨ㄋ丶丶
𫍲	讠臼丨ㄋ丶丶
𬯎	阝贵丨ㄋ丶丶
𬘬	纟青一一一一
𬘭	纟林一丨丶丶
𬴂	马非丨一一一
𫘦	马勹ノ一丨丨
𫟅	纟京丶一丶丶
𬘯	纟享丶一一一
𫘧	马录ㄋ一丶丶
𪣻	米ㄋノ一一
𡎚	户丨ㄋ丨丨
𬃊	木一丨丶丶
𬷕	甫鸟ノㄋ一一
𫐐	车臼ノㄋㄋㄋ
𬹼	齿人ノ丨丨丨
𧿹	母ㄋㄋ丶丶
𫶇	山带一丨丨丨
𫖮	山己一ノ丶丶
鿏	钅ノㄋ丶丶
𬭊	钅木一丨一一
𨱇	钅求一丨丶丶
𫓶	钅口丨ㄋ一一
𬭎	钅宀一ノ丶丶
𫖯	儿一ノ丶丶
𬱟	厃㔾一ノ丶丶
𫛭	犭王ノㄋ一一
𫷷	广钅ノㄋ丶丶
𬮱	门覀一丨一一
𬊤	火单丶ノ丨丨
𣸣	氵十一丨丶丶
𬴃	马丰一ノ一一
𫘨	马是丨ㄋ丶丶
𤧛	王帝丨ㄋ丨丨
𬪩	酉农丶ㄋノノ
𬒔	石止丨ㄋ一一
𬨎	车酋丶ノ一一
𫐓	车矛一丨丶丶
𫫇	口亚丶ㄋ丶丶
𫓹	钅其一丨丶丶
𬭚	钅享丶一一一
𬭛	钅氵ㄋノ丶丶
𬕂	工丨ㄋ丶丶
𬶋	鱼句ノㄋ一一
𬶍	鱼宀ノㄋㄋㄋ
𦝼	月米ㄋノ一一
𫔶	门自一丨丶丶
𫌀	礻丨ㄋ丶丶
𫖳	尹口一ノ丶丶
𫘪	马厂ノ丨丶丶
𫘬	马爫ㄋㄋ丶丶
𫞩	王艹一丨丶丶
𡐓	广ㄋ一丶丶
𪤗	羽ノ丶ノノ
𣗋	ノㄋㄋㄋ
𬸘	匚日ㄋノ一一
𬒗	石监丨ㄋㄋㄋ
𥔲	石吅一一ㄋㄋ
𫚖	此鱼ノㄋ一一
𨱏	钅艹ノ丶一一
𬭤	钅亻ノ丨丶丶
𫚕	鱼一丨丨丨
𬶐	鱼儿丶一丶丶
𬶏	鱼厃ㄋㄋㄋㄋ
𩽾	鱼宀ㄋノ一一
𬸚	犭讠一ノ一一
𬤝	讠惠丶ㄋ丶丶
𬙂	纟㝉丨ㄋ丶丶
𬭩	钅公ㄋ丶一一
𩾃	鱼免ノㄋㄋㄋ
𬸣	寒鸟ノㄋ一一
𫍽	讠罒丨ㄋ丶丶
𬴊	马米ノㄋ丨丨
𬞟	艹止丨ノ丶丶
𥕢	石曹一丨一一
𫟦	车㒸丶ㄋ丶丶
𬺈	齿大一丨丨丨
𫠜	齿臼ノㄋㄋㄋ
𪩘	山十丨ㄋ丨丨
𬭬	钅丰一一一一
𨱑	钅丨ㄋ丶丶
𬭯	钅敝丶ノ丶丶
𫗴	饣亠丨ㄋ一一
𬸦	族疋ノㄋ一一
𫄷	纟音丶ㄋ丶丶
𤩽	王十丨ㄋ丨丨
𬭳	钅壴丨ㄋ一一
𬭶	钅黑丨ㄋ丶丶
𫔍	钅番ノ丶一一
𬭸	钅米ノㄋ丨丨
𨱔	钅酋一丨丶丶
𬭼	钅㒸丶ㄋ丶丶
𫔎	钅矛丨ㄋ一一
𬸪	番鸟ノㄋ一一
𬶟	鱼束丨丨丨丨
𬶠	鱼柬一丨丶丶
𬶨	旡ノㄋ一一
𦈡	纟雨一ノ丨丨
𫄸	纟千丨ㄋ丶丶
𬟁	艹鬲ノㄋ一一
𥖨	石口丨ㄋ丶丶
𦒍	立里ㄋ丶一一
𬙊	纟黑一丨一一
𬶭	鱼祭ノㄋ丶丶
𩾌	鱼广ㄋ一丶丶
𨟠	目目ノ丨丨丨
𬶮	鱼壴丨ㄋ一一
𨭉	文一一ㄋ一一
𬙋	纟襄丶一丶丶
𤫉	王火丶一丶丶
𬺓	齿林ㄋ丨丶丶
𫚭	鱼巛丨ㄋㄋㄋ
屄	尸穴丶丶丶丶
逎	酉辶丶ㄋ丶丶

# 修订
哀	哀丶一丶丶
锿	钅哀丶一丶丶
裛	哀巴ㄋ丨ㄋㄋ
衰	哀一一一一一
蓑	艹哀一一一一
缞	纟哀一一一一
榱	木哀一一一一
衷	哀丨丨丨丨丨
蜊	虫禾丨丨丨丨

# 增补
亖	二二一一一一
凃	冫余ノ丶丶丶
嫑	不覀ㄋノ一一
㓦	百刂丨丨丨丨
嫋	女弓丶一一一
肀	肀ㄋ一丨丨